ō - о
bombax - еха
babae - леле
papae - мале
st - шш
fū - иу, йък
heu - ох
heu (+acc) - горко (на)
heus - ей, хей
ēheu - ох
eho - ехо
attat - ах, ох, ух, ех, иха (учудване), ей (предупреждение)
heia/eia - хайде
hei/ei - ех, въй, леле (израз на скръб, мъка, страдание, страх)
ēn - ей (показване), хайде, хайде де
em - ей (показване), ей на, ето
euax - охо
ecce - на
pol - вярно, със сигурност, баш
edepol - вярно, със сигурност, баш
mehercule/hercule/mehercle/hercle - навярно, сигурно, действително, определено
apage - марш, бегом, хайде, бегай, махай се
heia - хайде
macte - отлично, браво
vae - аман, леле, мале
vae (+dat) - горко (на)
prō - о
nē (+prōn) - че как не, със сигурност

cuccurū - куукуу (петел)
taratantara - тутуру??? звук на тромпет
bē - бее (беене)
poc poc - чук чук
toc toc - чук чук
