adhūc - засега, досега
anteā - преди това, преди, едно време
ante - преди
antehāc - досега, дотук (за време)
post - след
posteā - след това, после, след време
posthāc - отсега, натам (за време), оттук натам (за време)
postillāc - насетне, оттогава, нататък (за време)
anterius - преди, по-рано
posterius - след, по-късно

tunc - тогава
prīdem - одавна
ōlim - веднъж, едно време, някога
aliās - в друго време, друг път
quondam - едно време, преди
recēns - скоро, наскоро
nōndum - все още не, засега не
nequedum/necdum - и все още не, и докато още не
iam - вече, сега (вече нещо се е случило, нещо е така)
iam (+fut) - скоро
optimē - точно навреме
modo - тамън, тъкмо
dūdum - тамън, тъкмо
vixdum - едвам, тамън, тъкмо
nunc - сега (нещо се случва)
etiamnunc - дори сега
mox - скоро, след малко
brevī - след малко, скоро

interim - в това време
intereā - по същото време
