statim - веднага, на момента
cōnfestim - веднага, немедлено
īllicō/īlicō - на място, на мига, веднага
continuō - щом, немедлено, тутакси, веднага, завчас
prōtinus - веднага, немедлено, тутакси
extemplō - веднага, на момента
sēnsim - проточено, мудно, провлачено, бавно
subitō - внезапно, изневиделица, ненадейно, Току-виж
repente - изведнъж, тутакси, внезапно
paulātim - мудно, протакано, постепенно
ācūtum - точно, веднагически
subinde - веднага, тогаз, често, периодически, продължително

semper - винаги
ūsque - все, винаги, изцяло
numquam/nunquam - никога
aliquandō - някога, все някога, по някое време
quondam - някога
quandōcumque - когато и да е
perpetuō - постоянно, безспир, винаги, вечно

diū, diūtius, diūtissimē - задълго
aliquamdiū - за някакво време, доста време
paulisper - закратко
paulumper - закратко
inde ab (+abl) - откакто
ūsque ad (+acc) - докато, чак до
dōnec - докато, доколкото
quoad - докато не, чак до

opportūnē - в удобно време, в подходящно време
commodum - тъкмо, в удобен момент
commodo - тъкмо, таман
temperī, temperius - навреме
sērō - късно, със закъснение, по-късно

bellī - по време на война
duellī - по време на война
