bonus, melior, optimus - добър
malus, pēior, pessinus - лош
magnus, māior, māximus - голям
parvus, minor, minimus - малък
tantus - толкова голям
exiguus - малък, дребен
calidus - топъл
frīgidus - студен
dīmidius - намаляващ, смаляващ се
rēctus - прав, верен
prāvus - грешен
facilis -is - лесен
difficilis -is - труден
largus - щедър
multī, plūrēs, plūrimī pl - многоброен
multum, plūs plūris, plūrimum - много
paulum, minus, minimum - малко 
cautus - предпазлив, внимателен, мнителен
audāx -ācis - смел, решителен
temerārius - дързък
caecus - сляп
surdus - глух
mūtus - ням
claudus - съкат
mortālis -is - смъртен
tūtus - предпазен, защитен, в безопасност
attentus - внимаващ
vēlōx -cis - бърз, пъргав
fēlīx -cis - късметлив
ignārus - неук
nōtus - известен
nōbilis -is - аристократ, известен, важен
celsus - висок 
fallāx -cis - лъжлив, мамещ, грешен
iūcundus - приятен, задоволяващ
molestus - неприятен, болезнен, отврятителен
īmus - долен
summus -горен
tardus - бавен, закъсняващ
acerbus - кисел
nimius - твърде голям
dēbilis -is - болен, слаб, кекав
ēbrius - пиян
avārus - алчен
fidus - верен
fugitīvus - беглец
sapiēns -ntis - умен, мъдър, разумен
crūdēlis -is - жесток, див, освирепен
vetus veteris - вехт, стар, древен 
cārus - прескъпо
vīlis -is - малоценно, преевтино
idōneus - удобен, подходящ 
posterus - следващ
dīrus - ужасен
incolumnis - невредим, обезоръжен
ācer ācris - желаещ да действа
perpetuus - вечен
venustus - обичан
passus - сушен
glaber - гладък
rigidus - здрав
lentus - бавен, мързелив
superbus - надменен, арогантен
nēquam (ind), nēquior, nēquissimus - подъл, отвратителен, низък
dignus - заслужил
perītus - вещ, опитен
vīlis - пошъл
āmens -ntis - неразумен, откачен, изперкал. не с всичкия си
dūrus - твърд (и в преносен смисъл)
hirsūtos - с много козина, дебелокосмест
solitus - свикнал
capāx -cis - голям, обемист
ingēns -ntis - огромен, неестествен
atrōx -cis - див, жесток, страшен, свиреп
pius - съвестен, праведен
mendāx -cis - лъжлив, фалшив
tepidus - хладък
scaevus - ляв
supplex supplicis - молещ, коленичещ
vastus - обширен, огромен
alacer -cris - деятелен, щастлив, бърз, храбър
opulentus - богат
prīstinus - вехт
novissimus - последен
commodus - лесен
perennis -is - вечен
odōrātus - ухащ
ānxius - разтревожен
recēns -ntis - пресен, скорошен, нов, млад
continguus - слепен, съседен
pruīnosus - заскрежен, заледен
conterminus - съседен
gelidus - хладен, хладък
callidus - сръчен, хитър
sērious - късен, забавен
madidus - мокър
benignus - добронамерен
dōnātus - богат
pūtidus - развален
sollicitus - разтревожен
tortuōsus - трудно понятен
lepidus - красив
particeps -pis - участващ
macer - слаб, хилав, недохранен
assus - печен
ineptus - глупав, недодялан
hebes hebetis - глупав
sēpār -is - отделен
piger - мързелив
industrius - работлив
miser - нещастен
dīves dīvitis, dīvitior, dīvitissimus - богат
posterior - заден, следващ

superior, summus - по-горен, по-висок, пръв
īnferior, īnfimus - по-долен, по-нисък, последен
ulterior, ultimus - по-далечен
cirerior, citimus - по-близък
propior, proximus - по-близък

pulus - тъмноцветен, черен
prasinus - светло зелен
viridis -is - зелен
purpureus - пурпурен
ruber - червен
caerŭleus - светло син
rutilus - оранжево
crocinus - шафранено жълт

ambō (num) - и двата
