nōn - не
iam - сега (вече нещо се е случило, нещо е така)
nunc - сега (нещо се случва)
rūrsus - отново, повторно
tantum - само
ecce - ето
satis - достатъчно
nimis - прекалено, предостатъчно
tunc - тогава
māne - сутрин
adhūc - засега, досега 
deinde - после, след това
hodiē - днес
statim - веднага, на момента
vix - едвам
simul - по същото време
iterum - повторно, отново
cotīdiē - всеки ден
una ... cum ... - едновременно с
heri - вчера
crās - утре
subitō - внезапно
forte - незнайно защо, безцелно
haud - не, хич не
dēnique - накрая
quasi - като
inde - откъдето
inde ab - откакто
diū, diūtius, diūtissimē - задълго
paulisper - закратко
dēmum - най-сетне
prīdem - одавна
ideō - затова
donec - докато
ubique - навсякъде
iūre - заслужено, наистина
ferē - около, горе-долу
ūsque - все, винаги, изцяло
ūsque ad - докато, чак до
dumtaxat - само, единствено, точно
potius - по-точно, по-скоро 
funditus - напълно, изцяло
cōram - в присъствието на, пред
frūstrā - напразно, неуспешно
noctū - нощно, през нощта, нощес
libenter - със щастие
penitus - далеч
undique - отвсякъде
citō - бързо
cōmiter - добронамерено
ācriter - ожесточено, силно, жизнено
clam - тайно
strenuē - храбро
item - същно, по същия начин
interdiū - дневно, през деня
aegrē - трудно
amplius - повече
postrīdiē - на следващия ден
prīdiē - през предишния ден
adeō - дотолкова, точно
recēns - скоро, наскоро
incondonābile - непростимо
vicem - вместо, в следствие на
quācumque - където и да е, както и да е, по какъвто и да е начин
invicem - съвместно, един другиго
temperī - навреме
sērō - със закъснение, по-късно
nusquam - никъде
prōtinus - веднага
utrōque - от двете страни
prope - близо
propius - по-близо
saepe, saepius, saepissimē - често
rārō, rārius, rārissimē - рядко
quispiam - кой да е
absque - без
tam - толкова
quam - колкото
praetereā - също така, още повече, между другото

ubi - къде