ab - от (движение далече от, отдалечаване и т.н.)
accendere - горя, блестя, бушувам
accidere - случва се, сбъдва се, съвпадне (?)
acerbus - кисел
ācer - желаещ да действа
adhūc - засега, досега 
admirātiō - почитание, учудване, изумление(?)
ad - към (приближаване)
aetās - част от живота, възраст, поколение
affere - донасям
afferre - донасям
agere - действам, върша
agnīna - агнешко
agnus - агне
allicere - привличам
āmittere - губя, загубвам, давам (?)
amnis - река
ananāsa - ананас
animadvertere = забелязвам, отчитам, обръщам внимание на
appārēre - явявам се
apprehendere - грабвам, държа се за
apud - заедно с
āra - олтар
arca - кутия
ārdēre - горя, гневя се
ariēs - овен
armeniacum, praecoquium - дюля
aspergere - поръся, пръскам
astās - лято
attentus - внимаващ
audāx - смел, решителен(?)
auferre - отмъквам, отнасям
aurantium - портокал
autumnus - есен
aut - или (изключващо)
auxilium - помощ
avārus - алчен
banāna, mūsa, ariēna - банан
bāsium - целувка
bellum - война
bonus, melior, optimus - добър
bōs, taurus - бик
būbula - говеждо
caecus - сляп
caeruleās - синьо
calanthus - кошница
calidus - топъл
cantus - песен
caper - козел
capite pūnīre - екзекутирам
capra - коза
carēre - липсва ми, нуждая се от
carmen - песен
carō - месо
cārus - прескъпо
casa - колиба
cāsus - падеж
cautus - предпазлив, внимателен, мнителен(?)
celsus - висок 
cēnāre - вечерям
cēna - вечеря
cerasum - череша
certāmen - бой, битка
cervus - елен
cessāre - бездействам, въздържам се, почивам, върша по-малко
cingere - заобикалям
cingulum - колан
circumdare - обкръжавам, ограждам
claudus - съкат
cocus - готвач
cōgere - принуждавам, насилвам
colligere - събирам
conāri (d) - опитвам се, прибвам
cōnfidere - доверявам се
confitērī (d) - признавам
cōnsilium - съвет, решение, план
cōnsistere - спирам, прекъсвам(?)
cōnstāre - струва
contemnere - презирам
contrahere - сбръчквам
convenīre - пасвам, събирам се, подхождам
convertere - превръщам, заменям, променям
convīvium - събиране, банкет, гост (!)
coquere - готвя
cōram - в присъствието на 
corim - кора
corvus - гарван
cotīdiē - всеки ден
crās - утре
crēdere - вярвам, доверявам се 
crēscere - раста, проявявам се, повишавам, засилвам
cruciāre - мъча, измъчвам
crūdēlis - жесток, див, освирепен
crux - кръст
cucumeris - краставица
cucurbita - тиква
culīna - кухня
cum - когато
cum - с, заедно
cupere - купнея, желая
currere - тичам, бягам
cūr - защо
debēre - длъжен съм да, би трябвало да, прилично е да (?) 
dēbilis - болен, слаб
deinde - после, след това
delabī (d) - падам от, изпускам се
dēmum - най-сетне
dēnique - накрая
dēsīderāre - желая, жалея
dēsilīre - скачам
dēsinere - прекратявам, спирам
dēsistere - възпирам, прекратявам
dēsperāre - отчайвам се
dictum - слово, изказване, заповед
difficilis - труден
dīligere - обичам (роднина)
dīmidius - намаляващ, смаляващ се
dīrus - ужасен
disiungere - разделям
diu - задълго
dōnāre - подарявам, дарявам 
donec - докато
dracō - дракон, змей
dubitāre - съмнявам се
dumtaxat - само, единствено, точно
dum - докато
ēbrius - пиян
ecce - ето
egēre (+abl) - нуждая се от
ēicere - изхвърлям
ēlegere - избирам
ēnsis - меч
errāre - странствам, блуждая
et - и
ēvolāre - излитам, отлитам
ēvolvere - отварям, разтварям
excruciāre - измъчвам
exiguus - малък, дребен
experīrī (d) - откривам, тествам, доказвам, опитвам, пробвам
expōnere - оставям
exspectāre - чакам, очаквам
ex - от (предметът се е намирал в ограниченията на нещо)
facere - правя
facilis - лесен
fallāx - лъжлив, мамещ, грешен
fallere - греша, излъгвам се, бъркам се
famēs - глад
fēlīx - късметлив
ferē - около, горе-долу
ferre - нося
fīcus - смокиня
fidēs (III) - лира, струннен инструмент
fidēs (V) - вяра
fidicen - лирист
fieri - случва се, сбъдва се, създава се, подготвя се
flectere - свивам
fodus - верен
forte - незнайно защо, безцелно
fortūna - съдба
frāgum - ягода
fretum - проток
frīgidus - студен
fruī (d) - радвам се на, удовлетворява ме
frūstrā - напразно, неуспешно
frūstum - пържола
fugitīvus - беглец
funditus - напълно, изцяло
fundus - дъно
fūrtum - кражба
fūr - крадец
gallīnācea -пилешко
gallīna - кокошка
gallus - петек
gerere  - нося (дрехи и т.н.)
glaber - гладък
grātia - благодарност
gustāre - вкуся
habēre - имам, притежавам, задържам, смятам, състои се от, да владея,  
haedum - козле
haud - не, хич не
heri - вчера
hiems - зима
hodiē - днес
honōs - чест
iactūra - загуба, цена
iam - сега (вече нещо се е случило, нещо е така)
ideō - затова
idōneus - удобен, подходящ 
... igitur - затова 
ignārus - неук
immō - всъщност
īmus - долен
incipere - започвам
incolere - живея, пребивавам 
incolumnis - невредим
inde ab - откакто
inde - откъдето
induere - обличам се
ingenium - характер(?)
īnsidēre - язда
interpellāre - прекъсвам
interpellāre - прекъсвам (когато някойй говори)
invidia - завист
in - в, над
īra - гняв, яд
īsicium - кюфте
itaque - затова, и тъй
iterum - повторно, отново
iūcundus - задоволяващ
iūre - заслужено, наистина
iūs - справедливост, правосъдие
iuvāre - помагам
iuvenis - млад (около 30-ка)
labī (d) - падам, хлъзгам се
lābī - хлъзгам се
lacus - езеро
laedere - набия, пребия
lardum - бекон
largus - щедър
latēre - крия се
latēre - прикривам се
lēx - закон
libere - харесвам, обичам
licere - позволено е
līmō viridis - лайм
līmō - лимон
lucrum - печалба
lūgēre - оплаквам, жалея
lycopersica - домат
magnus, māior, māximus - голям
mālle - предпочитам
mālum paradīsī - нар
mālum - якълка
malus, pēior, pessinus - лош
māne - утро
medulla - месеста част
mēnsa - маса (като работна маса)
mēns - ум, разум(?)
mentīri (d) - лъжа
mergere - топя, потапям
merīdiēs - юг
minārī (d) (+dat) - заплашвам, действам страшно
minister - сервитьор, келнер
molestus - неприятен, болезнен, отврятителен
monēre - предупреждавам
mora - прекъсване, забавяне
morī (d) - умирам
mortālis - смъртен
mōrum īdaeum - малина
mōrum - къпина
mōs - морал, ценност
multī, plūrēs, plūrimī - многоброен
multum, plūs plūris, plūrimum - много
mundus - свят
mūnus - 
mūtus - ням
nascī (d) - раждам се
neque - нито, и не
...ne - ли
nimis - прекалено, предостатъчно
nimius - твърде голям
nisi - освен, ако не
nōbilis - аристократ, известен, важен
noctū - нощно, презнощта, нощес
nōtus - известен
nucleus - зърно
nūgae - глупости, проститии
num - ли
nunc - сега (нещо се случва)
nux - ядка, плод с черупка
oboedīre - подчинявам се
occidēns - запад
occurere - срещам, изправен съм срещу, съвпадам
offa - парче месо (и по общо парче храна)
olīva - маслина
opera - работа, грижи
operīre - покривам, прикривам(?)
oportāre - редно е
optāre - избирам, желая
opus - дело, труд
ōrdināre - подреждам
ōrdō - редно
oriēns - изток
orīri (d) - изгрявам, появявам се
ostendere - показвам
ovilla - овче
ovis - овца 
ōvum dūrum - варено яйце
ōvum frictum - яйце на очи
ōvum permixta - бъркано яйце
ōvum - яйце
paenitēre, -uisse - раззкайвам се, съжалявам
palmula. caryōta, dactylus - фурма
parcāre - въздържам се
pārēre - подчинявам се (изпълнявам?)
parere - раждам
parvus, minor, minimus - малък
pāscere - наслаждавам се
passus - сушен
paulisper - закратко
paulum, minus, minimum - малко 
pāx - мир
pecūlium -  
pepō, mēlopepō, citrullus lānātus - диня
percutere - блисгам, тропам
perferre - издържа
perficere - завършвам, довършвам
perīculum - беда
perna - шунка
perpetuus - вечен
persica - праскова
pervenīre - стигам, достигам
per - чрез
phantasma - призрак
pirum - круща
placēre - задоволявам
poena - наказание
pōmum - плод
porcīna, sūina - свинско
porcus. sūs - свиня
portāre - нося
posterus - следващ
potestās - сила, възможност
potiō - напитка
potius - по-точно, по-скоро 
praebēre - давам
praedō - пират
praeesse - управлявам, ръководя
praemium - награда, награждение, подарък
praestāre - изпълнявам
praeter - освен
prāvus - грешен
preatereā - също така, между другото (?)
precāri (d) - умолявам
premere - натискам, потискам
prīdem - одавна
procul - далече 
prōmere - обещавам
properāre - бързам, забързвам се
prope - близо
propter - заради, поради
prūnum - слива
purpureus - пурпурно
quaerere - търся, издирвам
quam - колкото
quasi - като
quercus - дъб
...que - и
quia - защото
quid - какво
quin - защо не
quoque - също
quō - накъде
rēctus - прав, верен
redimere - откупя
relinquere - оставям
reminīscī (d) - спомням
rēmus - гребло
reperīre - 
requīrere - търся, питам
respicere - поглеждам отново
rigidus - здравnōn - не
rīma - дупка
ripa - речен бряг
rogāre - питам
rostrum - човка
ruber - червено
rūmor - слух (като несигурна новина)
rūrsus - отново, повторно
rutilus - оранжево
sacerdōs - свещеник
saltāre - 
salūs - спасение
salvāre - спасявам
sapiēns - умен, мъдър, разумен
satis - достатъчно
scamnum - стол, стъпало
scelus - престъпление, извръщение
scēptrum - скиптър, жезъл
secāre - сека, разсичам
sed = но
senex - старец
septentriōnēs - север 
servāre - спасявам 
sīcut - като
simul - по същото време
sine - без
sīn - обаче, ако обаче, а пък ако 
sitis - жажда
sīve - или
solēre - свъкнал съм да
speculum - огледало
spērāre - надявам се
spernere - презирам
spēs - надежда
statim - веднага, на момента
stertere - хъркам
subitō - внезапно
summus -горен
supplicium - страдание, мъчение
surdus - глух
tamquam - както, като, сякаш
tam - толкова
tantum - само
tantus - толкова голям
tardus - бавен, закъсняващ
tegere, tēxisse, tēctum - покривам, прикривам
temerārius - дързък
tenēre - поставям
tergēre - избърсвам
tībīcen - флейтист
tollere - вдигам
tuēri (d) - закрилям
tumultuārī (d) - обърквам, разбърквам 
tunc - тогава
turbāre - разбърквам, развълнувам
tūtus - предпазен, защитен, в безопасност
ubique - навсякъде
ubi- къде?
umerus - рамо
una ... cum ... - едновременно с
unde - откъде
ūrēre - горя
ūsque ad - докато, чак до
ūsque - все, винаги, изцяло
vacca - крава
vaccīnium, myrtillus  - боровинки
vehere - пренасям
vēlōx - бърз
vel - или
venustus - обичан
verō - но
versāri (d) - въртя се, неспирно се движа
vērum - ни, всъщност
vēr - пролет
vesper - вечер
vestīre - обличам се
vetāre - забранявам, не допускам
vetus - вехт, стар, древен 
vīlis - преевтино
viridis - зелено
vīta - живот
vitulina - телешко
vitulus - теле
vix - едвам
vorāgō - бездна, водовъртеж (?)
vulnus - рана
