mēnsa - маса (като работна маса)
speculum - огледало
umerus - рамо
lacus - езеро
māne - утро
vesper - вечер
hiems - зима
vēr - пролет
astās - лято
autumnus - есен
oriēns - изток
occidēns - запад
septentriōnēs - север 
merīdiēs - юг
mora - прекъсване, забавяне
auxilium - помощ
opus - дело, труд
fretum - проток
dictum - слово, изказване, заповед
tībīcen - флейтист
potestās - сила, възможност
mundus - свят
phantasma - призрак
vorāgō - бездна, водовъртеж (?)
perīculum - беда
praedō - пират
pecūlium -  
fundus - дъно
vīta - живот
lucrum - печалба
spēs - надежда
iactūra - загуба, цена
fidēs (III) - лира, струннен инструмент
fidicen - лирист
cantus - песен
carmen - песен
salūs - спасение
fūr - крадец
fūrtum - кражба
invidia - завист
fortūna - съдба
rēmus - гребло
cōnsilium - съвет, решение, план
cēna - вечеря
famēs - глад
sitis - жажда
cocus - готвач
culīna - кухня
minister - сервитьор, келнер
convīvium - събиране, банкет, гост (!)
nux - ядка, плод с черупка
carō - месо
scelus - престъпление, извръщение
mōs - морал, ценност
potiō - напитка
rūmor - слух (като несигурна новина)
mūnus - 
fidēs (V) - вяра
crux - кръст
iuvenis - млад (около 30-ка)
praemium - награда, награждение, подарък
poena - наказание
iūs - справедливост, правосъдие
lēx - закон
nūgae - глупости, проститии
supplicium - страдание, мъчение
senex - старец
grātia - благодарност
aetās - част от живота, възраст, поколение
amnis - река
ripa - речен бряг
bellum - война
pāx - мир
vulnus - рана
ēnsis - меч
opera - работа, грижи
certāmen - бой, битка
ingenium - характер(?)
mēns - ум, разум(?)
bāsium - целувка
ōrdō - редно
īra - гняв, яд
admirātiō - почитание, учудване, изумление(?)
scamnum - стол, стъпало
sacerdōs - свещеник
cāsus - падеж
casa - колиба
quercus - дъб
dracō - дракон, змей
āra - олтар
arca - кутия
rīma - дупка, процеп
honōs - чест
calanthus - кошница
scēptrum - скиптър, жезъл
cingulum - колан
radius - лъч
sūdor - пот
calculus - камъче
fōns - извор, фонтан
gutta - капка
nepōs - внук, внучка, разпуснат човек, разпътник
opecrulum - капак
cāseus - сирене
antrum - пещера
unda - вълничка
spēlunca - пещера
cāligō - плътен облак
vapor - пара
nebula - мъгла
unguis - нокът
ratis - рафт, лодка
lapis - камък
pilus - козина
scintilla - искра
ferula - палма
venēnum - отрова
socius - съюзник
anguis - змя, змей
pharetra - колчан
rādix - корен
cortex - кора
frōns - листа, зеленина, клонче с листа
acus - игла
venia - прошка, опрощение
sūcus - сок, смола
laqueus - примка, капан
tēla -паяжина
statuā - статуя
līmen - праг
sertum - венец
tabernāculum - палатка
vāgīna - ножница
vātēs - пророк, ясновидец
dūmus - храст
latibulum - скривалище
splendor - блясък
gemitus - стон
lympha - вода, прозрачна течност
scāla - стълба
solium - трон
īnsidiae - засада, клопка
pondus - тежест, бреме
macula - петно
peregrīnus - чужденец
cloāca - канализация
prōdigium - учудване (?)
classis - клас, класа
cura - заседателна зала, сградата на сената
coniūrātiō - заговор (?)
exsilium - заточение
obsidiō - обсада
stipendium - заплата, надница
turba - тълпа
histriō - актьор
discīmen - опасност
coetus - събрание (?)
sēcessiō - разкол, отцепване, сепаратизъм
prex - жалба, молба
turris - кула
ebor - слонова кост
clādēs - клане (?)
occasiō - момент, възможност
lōrīca - броня
vadum - плитчини
stagnum - мочурище
tumulus - хълмче
socer - тъст
crūdēlitās - жестокост
aerārium - държавна хазна
hērēs - наследник
vīcus - село, градче
farīna - брашно
necessarius - приятел
obses - заложник, залог
calamitās - нещастие
sarcinae - товар, снаряжение, екипировка
aura - въздух, миризма, вятър
prōlis - чадо, рожба
harundō - въдица
stīva - дръжка
vīcīnia - близост
tellus - земя (като елемента), Земята, земя (като на каквото стъпваме)
caupōna - странноприемница
marsūpia - кесия
onus - тежест, тегоба, трудност
nēquitia - несправедливост, мерзост
pariēs - стена
blanditia - комплимент, лъскание
murmuris - шепот, тих звук
anhelitus - дъх, дишане
tumulus - гробница
arvum - поле
amicitus - наметало
rictus - челюст
pulvis - прах, пясък
rūpēs - скала, канара
mucrō - острие, връх
rogus - погребална клада
fūnis - въже
incendium - пожар
portiō - част
meretrīx - проститутка
supellex - мебел
divīnus - ясновидец, гадател
libīdō - желание, страст
marmor - мрамор
basilica - обществена сграда за различни дейности
sēcrētum - тайна
reus - грешник, защита в съда
vitium - порок
mentium - брадичка
sodālis - приятел
nūmen - провидение
contāgiō - зараза
victima - жертвено животно, жертва
indulgentia - прошка
ritus - ритуал, обред
facultās (+gen) - способност, възможност, шанс
ēdere - издавам (книга), създавам, раждам, произвеждам
latrō - грабител, плячкосник
iurgium - свада, кавга, раздяла, бой
liquor - течност
fraus - лъжа
culpa - вина, грешка
effigiēs - образ, вид
dolus - измама
pellis - кожа, кожух
cutis - кожа
rūga - бръчка
nātus - син, рожба
nīsus - труд
melos (ind) - песен
augurium - ясновидство
ōmen - поличба
subsidium - подпомагане
prandium - обяд
thēca - чанта
exemplar - пример
maacellum - месарница
unguentum - масло, мазило
porticus - колонада, стоа
sēcessus - самотно, скришно място
cella - стая, затворено място
piscīna - басейн
lutum - кал
ēsca - храна
ferculum - поднос
placenta - кекс, торта
facula - факла
pulvīnus - възглавница
fraudātor - мошеник
iūdex - съдия
praecō - вестител, глашатай
pugnantiа (pl) - противоречие, несъответствие

pōmum - плод
mālum - якълка
pirum - круща
persica - праскова
frāgum - ягода
prūnum - слива
aurantium - портокал
mālum paradīsī - нар
līmō - лимон
līmō viridis - лайм
armeniacum, praecoquium - дюля
cerasum - череша
mōrum - къпина
mōrum īdaeum - малина
vaccīnium, myrtillus  - боровинки
pepō, mēlopepō, citrullus lānātus - диня
cucurbita - тиква
banāna, mūsa, ariēna - банан
ananāsa - ананас
lycopersica - домат
cucumeris - краставица
olīva - маслина
fīcus - смокиня
palmula. caryōta, dactylus - фурма
mālum pūnicum - нар
spīca - жито
far - спелта
holus - зеленчук
bēta - морков
lactūca - маруля
siliqua - боб

corim - кора
nucleus - зърно
medulla - месеста част

pecoris - добитък
equus - кон
asturcō - ат
assinus - магаре
pavō - фазан
olor - лебед
luscinia - врабче
corvus - гарван
cornīx - врана
gallus - петек
gallīna - кокошка
ōvum - яйце
porcus. sūs - свиня
bōs, taurus - бик
vacca - крава
vitulus - теле
ariēs - овен
ovis - овца 
agnus - агне
caper - козел
capra - коза
haedum - козле
cervus - елен
aper - глиган
ursus - мечок
ursa - мечка
sīmius - маймуна
arānea - паяк
rāna - жаба
lepus, -oris - заек


gallīnācea -пилешко
būbula - говеждо
vitulina - телешко
porcīna, sūina - свинско
ovilla - овче
agnīna - агнешко
frūstum - пържола
īsicium - кюфте
offa - парче месо (и по общо парче храна)
perna - шунка
lardum - бекон
ōvum frictum - яйце на очи
ōvum dūrum - варено яйце
ōvum permixta - бъркано яйце

rostrum - човка

venetus - тъмно синьо
caeruleās - светло синьо
viridis - зелено
purpureus - пурпурно
ruber - червено
rutilus - оранжево
crocinum - жълто (шафранено)
