ad - към (приближаване)
prope - близо
apud - заедно с
per - чрез, през
trāns - през
ob - вместо, заради
iūxtā - до, близо, с
ante - пред
adversam - срещу, към
cis - близо, от тази страна
citrā - близо, от тази страна
cicrā - около, близо до, приблизително (за време)
circum - около
contrā - срещу
ergā - към
extrā - отвън, извън
inter - среден
intrā - в, вътре в
īnfrā - под, надолу от
praeter - освен
propter - заради, поради
post - след, зад
secundum - след, зад
ultrā - извън
suprā - над, нагоре от
advcrsus - към, в посока на

cum - с, заедно
sine - без
abs, ab, ā - от (движение далече от, отдалечаване и т.н.)
ex, ē - от (предметът се е намирал в ограниченията на нещо)
procul - далече
dē - за, относно, от
prō - вместо
prae - заради
cōram - пред, сред


in - в, над
sub - под
super - над



