pārēre - подчинявам се, изпълнявам
agere - действам, върша
facere - правя
portāre - нося
vehere - пренасям
tenēre - поставям
tergēre - избърсвам
cōnsistere - спирам, прекъсвам, заставам на място
ostendere - показвам
cōnstāre - струва
convenīre - пасвам, събирам се, подхождам
errāre - странствам, блуждая
quaerere - търся, издирвам
reperīre - изобретя, намеря, получа
parere - раждам
incolere - живея, пребивавам 
incipere - започвам
operīre - покривам, прикривам
ferre - нося
afferre - донасям
gerere  - нося (дрехи и т.н.)
induere - обличам се
vestīre - обличам се
solēre - свъкнал съм да
mergere - топя, потапям
dēsinere - прекратявам, спирам
licere - позволено е
exspectāre - чакам, очаквам
tollere - вдигам
interpellāre - прекъсвам (когато някойй говори)
prōmere - обещавам
oportāre - редно е
carēre - липсва ми, нуждая се от
debēre - длъжен съм да, би трябвало да
occurere - срещам, изправен съм срещу, съвпадам
animadvertere - забелязвам, отчитам, обръщам внимание на
dīligere - обичам (роднина)
mentīri (d) - лъжа
dubitāre - съмнявам се
fallere - греша, излъгвам се, бъркам се
crēdere - вярвам, доверявам се 
monēre - предупреждавам
conāri (d) - опитвам се, прибвам
percutere - блисгам, тропам
cupere - купнея, желая
accidere - случва се, сбъдва се, съвпадне
iuvāre - помагам
relinquere - оставям
ēvolāre - излитам, отлитам
perficere - завършвам, довършвам
ūrēre - горя
cingere - заобикалям
cessāre - бездействам, въздържам се, почивам, върша по-малко
oboedīre - подчинявам се
ēvolvere - отварям, разтварям
pervenīre - стигам, достигам
disiungere - разделям
rogāre - питам
tumultuārī (d) - обърквам, разбърквам 
salvāre - спасявам
servāre - спасявам 
ēicere - изхвърлям
nascī (d) - раждам се
morī (d) - умирам
apprehendere - грабвам, държа се за
habēre - имам, притежавам, задържам, смятам, състои се от, да владея,  
versāri (d) - въртя се, неспирно се движа
mālle - предпочитам
spērāre - надявам се
dēsperāre - отчайвам се
dēsilīre - скачам
allicere - привличам
confitērī (d) - признавам
dōnāre - подарявам, дарявам 
āmittere - губя, загубвам, пускам, освобождавам (слуга)
orīri (d) - изгрявам, появявам се
precāri (d) - умолявам
secāre - сека, разсичам
appārēre - явявам се
fruī (d) - радвам се на, удовлетворява ме
praeesse - управлявам, ръководя
cēnāre - вечерям
perferre - издържа
ēlegere - избирам
coquere - готвя
gustāre - вкуся
aspergere - поръся, пръскам
contrahere - сбръчквам
placēre - задоволявам
auferre - отмъквам, отнасям
vetāre - забранявам, не допускам
capite pūnīre - екзекутирам
cōnfidere - доверявам се
latēre - крия се, прикривам се, дебна, укривам
tuēri (d) - закрилям
flectere - свивам
optāre - избирам, желая
interpellāre - прекъсвам
lābī - хлъзгам се
premere - натискам, потискам
minārī (d) (+dat) - заплашвам, действам страшно
reminīscī (d) - спомням
crēscere - раста, проявявам се, повишавам, засилвам
redimere - откупя
cōgere - принуждавам, насилвам
circumdare - обкръжавам, ограждам
properāre - бързам, забързвам се
praestāre - изпълнявам
dēsistere - възпирам, прекратявам
affere - донасям
laedere - набия, пребия
lūgēre - оплаквам, жалея
pāscere - наслаждавам се
libere - харесвам, обичам
accendere - горя, блестя, бушувам
turbāre - разбърквам, развълнувам
requīrere - търся, питам
cruciāre - мъча, измъчвам
excruciāre - измъчвам
ōrdināre - подреждам
fieri - случва се, сбъдва се, създава се, подготвя се
stertere - хъркам
praebēre - давам
īnsidēre - язда
labī (d) - падам, хлъзгам се
delabī (d) - падам от, изпускам се
expōnere - оставям
saltāre - скачам, танцувам
paenitēre, -uisse - разкайвам се, съжалявам
convertere - превръщам, заменям, променям
currere - тичам, бягам
experīrī (d) - откривам, тествам, доказвам, опитвам, пробвам
tegere, tēxisse, tēctum - покривам, прикривам
egēre (+abl) - нуждая се от
contemnere - презирам
respicere - поглеждам отново
dēsīderāre - желая, жалея
ārdēre - горя, гневя се
spernere - презирам
colligere - събирам
parcāre - въздържам се
fulgēre - блести, свети
inspicere - наблюдавам
tegere - прикривам
plangere - бия се в гърдите от печал
calefacere - стоплям, загрявам
ērigere - възбуждам, издигам
trānsfīgere - промуша
flagrāre - пламтя
pingere, pīnxisse, pictum - рисувам
gestāre - нося
consciscere - да реша
consciscere (+sibi) - да си наплека
taxere - плета
cēlāre - скривам
obdormīre - заспивам
commovēre - разчуствам
caelāre - правя резба, дялкам надпис в камък
calcāre - тъпча, стъпвам
paenitēre - разкайвам се, гризе ме съвестта
īnsidāre - чакам в засада, заговорнича, поставям клопка, внимавам
diffugere - разпръсквам
venārī (d) - ловувам, диря, преследвам
dīlacerāre - гърча се
praestāre - надминавам, участвам, доставям, отговорен съм
invīsere - навестявам, посещавам
invadīre - навлизам, отнемам
invadīre in - нападам
dēficere ab - оставям
praedārī (d) - грабя, плячкосвам
iungulāre - убивам
molere - стривам
maturāre - съзрявам, забързвам, движа се прибързано
impedīre - забавям
expedīre - забързвам
concīdere - убивам
perservāre - продължавам
praecipere - ръководя, предвождам
adamāre - жадувам, страстно обичам
epulārī (d) - пирувам
iterāre - повтарям
vagāre - странствам
innitī, innixum esse (d + abl) - облягам се
devovēre - заклевам се, проклинам, кълна
condīre - погребвам, заравям
vītāre - избягвам
ēvāgīnāre - вадя (меч, нож)
tentāre - опитвам, подтиквам
cēlāre - крия
ānxiāre - тревожа се
condonāre - прощавам
blandīrī (d) - ухажвам, лаская, давам комплимент, очаровам
querī (d) - оплаквам се, обжалвам
statuere - решавам, поставям, изгражам
spumāre - пеня
compescere - въздържам се, преграждам, утолявам
perēmere - убивам, унищожавам
extinguere - убивам, угасвам, разрушавам
pluere - вали
dissipāre - разпръсквам, унищожавам
abundēre (+abl) - стига ми, имам повече от достатъчно
īnsistere - настоявам
damnāre - осъждам
praestingere - замижа
mināre - заплашвам, бутам, водя животни
incidere - появява се, случва се
observāre - тача, почитам
nocēre - вредя, ранявам, пакостя
оpprimere - насилвам, надвивам
dēcipere - мамя
ingēmescere - стена, ридая
extendere - разширявам
intendere - опъвам
ēlevāre - подценявам, принизявам
partuīre - бременна съм
gemere - тъжа, стена
ciēre - друсам, бъркам
perpāscere - угоявам
satiāre -да достига, задоволява
satisfacere - задоволявам, извинявам се, обезщетявам
fastīdīre - не понасям, не навиждам, отвращавам се от нещо
ligāre - вризвам, сглобявам
alligāre - завързвам, обвинявам, включвам
prandere - обядвам
ēdiscere - наизустявам
vacāre - почивам
sufficere - да е достатъчно
ēvigilāre - разсънвам се, събуждам се
luctārī (d) - боря се
sitīre - жаден съм
mandūcāre - дъвча, смилам, глозгам
propīnāre - вдигам тост, наздравица
iūrāre - заклевам се
adhibēre - допитвам се
praedicāre - обявявам
exōrāre - измоля
convincere - убеждавам, показвам, доказвам