niveus - снежно бял
eburneus - бял като слонова кост
cānus - бял
candidus - бляскаво бял
albus - матово бял
niger - бляскаво черен
    perniger - възчерен
āter - матово черен
pulus - тъмноцветен, черен
prasinus - светло зелен
viridis, -is - зелен
purpureus - пурпурен
ruber, rubrī - червен
rubeus/robeus - червен, червеникав
rūbīginōsus/rōbīginōsus - ръждив, ръждиво-червен
rūfus - риж, рижав, червен, червеникав
surrūfus/subrūfus - рижавеещ, с цвят сходен до рижия
caerŭleus - небесно син
azurīnus - лазурен
blavus/blaveus - син
caesius - синьо-сив, синеок, сивоок
rutilus - оранжев
croceus - златно жълт
crocinus - шафранено жълт
flāvus - бледожълт, жълтеникав, рус
pallidus - блед, жълтеникав
lūteus - шафраненожълт, оранжев, речвеникав
carbōnārius - въгленочерен
mūrīnus - мишoсив
cinereus - пепеляво сивкав
