amāns, amantis - любящ
agēns - действащ
potēns - можещ, умеещ, способен
potēns (+abl) - притежаващ
  impotēns - неможещ, неумеещ, неспособен
  omnipotēns - всемогъщ
ēloquēns - красноречив, сладкодумен
continēns, -entis - въздържан, непрекъснат, свързан, ограждащ, съседен
patiēns, patientis - търпелив
impatiēns, impatientis - нетърпелив
dīligēns, dīligentis - усърден
absēns, absentis - отсъстващ, липсващ
praesēns, praesentis - присъстващ, наличен, сегашен, текущ, настоящ, благоприятен
sapiēns, -ntis - умен, мъдър, разумен
fervēns, -entis - кипящ, пламенен, жарък, въодушевен
obstināns, -antis - инатлив
permanēns - постоянен
animāns - одушевен, съживяващ, въодушевяващ, ободряващ
virēns - зеленеещ, зелен, цъфтящ, жизнен
flōrēns - цъфтящ, процъфтяващ, преуспял
cōnstāns - спокоен
nitēns - блестящ, бляскав, пищен
fulgēns - светещ, бляскащ
egēns - нуждаещ се, окаян, беден
vigilāns - будуващ, буден
  vigil - буден, зорък, който е нащрек
crēdēns - вярващ, даващ на заем
decēns - удобен, сгоден, уместен, подходящ, достоен, приличен
oriēns - изгряващ, произхождащ, явяващ се
occidēns - залязващ, снижаващ се, изчезващ, губещ се, разпадащ се, умиращ, биващ унищожен
appropinquāns - приближаващ, приближаващ се, наближаващ
reverēns - почтен, почтителен, внушителен, страхопочитащ, почитащ
exsultāns - радващ се, ликуващ
rancēns - гниещ, миришещ, смърдящ
vacāns - празнещ, бездействащ
ēvellēns - изтриващ, скубещ
pavēns - страхуващ се, треперещ от страх
anhēlāns - задъхан, пъхтящ
efficiēns - ефективен, ефикасен, действен, изработващ
algēns - студуващ, мразуващ
praesidēns - седящ отпред, защитаващ, бранещ, вардещ, предпазващ, председателстващ, управляващ
sedēns - седящ, седнал
ōscitāns - зеещ, прозяващ се, изморен, сънлив, равнодушен
ēlēgāns - завещаващ на нероднина
dēspondēns - обещаващ, отказващ се от притежание
audiēns - слушащ (физически), внимаващ, присъстващ
audiēns (+dat) - слушащ (подчиняващ се)
  exaudiēns - слушащ, долавящ, внимаващ разбиращ
  oboediēns - слушащ (подчиняващ се), послушен, покорен
olēscēns - растящ
  exolēscēns - израстващ
tollēns - вдигащ, носещ, отнасящ, отмъкващ, премахващ, убиващ, унищожаващ
sequēns - следващ
nocēns - вреден, увреждащ, раняващ, лош, порочен, престъпен, виновен
  innocēns - безобиден, благ, почтен, чистосърдечен, безупречен, невинен
repellēns - отблъскващ, отхвърлящ
migrāns - мигриращ, заминаващ, пренасящ, нарушаващ
micāns - трептящ, трепкащ, трепетлив, блещукащ, мъждеещ, мъждив, мъжделив, мержелеещ се, проблясващ
flagrāns - пламтящ, горящ (от страст), огнен, горещ, изгарящ, възмутителен

perturbātus - шашардисан
perversus - извратен, зъл
ustus - горян
haustus - точен, източен, излят
cultus - поддържан, обработен, закрилян, тачен, почитан, украсен, разкрасен
  incultus - неподдържан, необработен, занемарен, изоставен, неукрасен
dōtātus - богат, охолен, облагодетелстван
dīlēctus - любим, скъп
invīsus - невиждан, непоносим, омразен, невидим
contеmptus - презрян, омразен, отвратителен, малоценен
quaesītus - търсен, допитан, желан, особен, рядък, нов, умишлен
noxius - опасен, виновен, престъпен
innoxius - безопасен, невинен, невредим
perpāstus - гоен
status - назначен
absolūtus - завършен, довършен, безусловен
sēcrētus - отделен, усамотен, споделен с малко на брой хора, таен, секретен
nātus - роден
  renātus - прероден
prōgnātus - потомски, рожбен
ōrnātus - украсен, окичен, гиздав
praeditus - окичен, украсен
intactus - недокоснат, невредим
vulnerātus - ранен
exercitātus - упражнен, подготвен, опитен
rēctus - верен, прав (в смисъл на истинен), прав (в смисъл на права линия)
cautus - предпазлив, внимателен, мнителен
solitus - привикнал, свикнал, привичен
  insolitus - непривикнал, непривичен, необичаен
attentus - внимателен, осторожен, внимаващ
nōtus - знаен, известен
  ignōtus - незнаен, неизвестен
īrātus - бесен
gemmātus - украсен със скъпоценни камъни
tacitus - мълчалив, премълчан, безмълвен, ням, тих, прикрит, таен
altus - висок, дълбок
beātus - блажен, приятен, щастлив
suspectus - заподозрян, съмнителен, недоверен
perspectus - виден, очевиден, очебиен, известен
dēbitus - дължим
arbitrātus - решен, преценен
maestus - тъжен, опечален
exspectātus - очакван
  inexspectātus - неочакван
acūtus - остър (буквално), остър (проницателен), остър (пронизителен звук), остър (рязък), остроумен, шпиц, шилест, пикантен
obtūnsus - тъп, притъпен
prīvātus - частен, личен
conditus - изграден, довършен, събран, скрит, погребан, заровен
  absconditus - невидим, прикрит, неясен, таен
  inconditus - груб, недодялан
sepultus - погребан
  īnsepultus - непогребан
expedītus - подготвен, леко въоръжен, военизиран
scelerātus - долен, престъпен, порочен
occultus - скрит, таен
mōtus - местен, възбуден, разтревожен
  immōtus - неподвижен, спокоен, незасегнат
contentus (+abl) - доволен (от), задоволен (от), удовлетворен (от)
calceātus - обут
spērātus - очакван, предвиден
  īnspērātus - ненадеен, неочакван, непредвиден
factus - извършен, довършен, свършен
  īnfectus - неизвършен, недовършен, несвършен, суров
  perfectus - завършен, изпълнен, свършен, съвършен, перфектен
cōnsīderātus - обмислен, внимателен
  incōnsīderātus - необмислен, лекомислен, безразсъден, невнимателен
armātus - въоръжен
odōrātus - уханен, благоуханен, ароматен
citus - задвижен, раздвижен, бърз, призован, възбуден
exsecrātus - прокълнат, проклет, отлъчен
monitus - съветван
admonitus - посъветван
offēnsus - обиден, накърнен
animātus - жив, одушевен, оживен, пресен
  exanimātus - мъртъв, в безсъзнание, немощен, изтощен, отпаднал, изморен, отслабен
mēnsus - мерен, измерен, премерен, разпределен
  immēnsus - неизмерим, безкраен, безграничен, необятен
praefectus - поставен начело
lautus/lōtus - украсен, бляскав, разкошен, мит, чист
condītus - подправен, овкусен
adultus - зрял, възрастен
positus - поставен
  oppositus - противопоставен, отсрещен
tōnsus - стриган, рязан, бръснат, кастрен
  intōnsus - нестриган, нерязан, небръснат, некастрен
ultus - отмъстен
  inultus - неотмъстен
subnīxus - крепящ се на
perditus - развратен, разрушен, унищожен, изгубен, фалирал
impedītus - забавен, възпрепятстван, препречен
laesus - накърнен, наранен, потърпевш, пострадал
  illaesus - ненакърнен, ненаранен, невредим
prōmissus - изпратен, обещан, пратен напред, дълъг (за коса)
dēfatīgātus - изморен, изтощен
accīnctus - препасан, снаряжен, подготвен, оборудван
neglegēns - небрежен, нехаещ
observāns - тачещ, обръщащ внимание, наблюдателен
ēditus - висок, почетен, изтъкнат
dēditus - предаден, отдаден
audītus - чут, познат
  inaudītus - нечуван
exquīsītus - издирен, изискан
citātus - развълнуван, бърз, забързан, подранил
arcuātus - дъговиден, сводест
placitus - приятен, ласкав, угоден
invictus - непобедим
attonitus - настръхнал, поразен, гръмнат, като гръмнат, шашардисан
dēfēnsus - защитен, отведен
īnfēnsus - враждебен, опасен, жлъчен, ехиден
effūsus - разпилян, разпръснат, разсеян, рядък
profūsus - прекомерен, наднормен, разточителен, разхитителен
acceptus - приет, допуснат, възприет, приятен, признат
receptus - приет, получен, взет обратно, възстановен
obsūtus - пришит
obsolētus - остарял, негоден, износен
datus - даден, предложен, отстъпен
    praeditus (+abl) - надарен (с), снабден (с)
dēfīnītus - определен, ограничен, ограден, точен, обвързан с частния случай
trānsversus - напреко поставен, пресечен, засечен
textus - тъкан, плетен
  intextus - втъкан, вплетен
  praetextus - с фриз, с декоративен/украсен ръб
versātus - обърнат, врътнат
castrātus - кастриран
mīrātus - учуден
dēmīrātus - удивен, смаян
lātus - носен, износен, изстрадан, докладван
  dēlātus - отнесен, отстранен, продаден, доставен, съобщен
  ēlātus - възнесен, произнесен, износен, погребан (от носен до гроба), изпуснат, издигнат, произнесен, преувеличен
  trānslātus - преносен, преместен, отдаден, преведен
morātus - забавен, закъснял, застоял
functus - направен, изпълнен, понесен, изтърпян, мъртъв
  dēfunctus - довършен, завършен, мъртъв
ratus - обмислен, отсъден
vestītus - облечен, пременен, украсен
gravātus - утежнен
cavātus - издълбан, кух, пробит, продупчен
vōtus - заклет
pūnctus - убоден, пробит, ужилен, раздразнен, притеснен, разтревожен, на точки (белязан с точки)
occupātus - нает, зает
suētus - свикнал, обичаен, привичен
  īnsuētus - несвикнал, неопитен, необичаен
vēnātus - ловуван, преследван
frēnātus - обуздан (буквално), обуздан (преносно), оборудван
  dēfrēnātus - разюздан
frāctus - счупен, разрушен, победен, изтощен, слаб
admīrātus - учудил се, уважил
meritus - заслужен
  immeritus - незаслужен
reciperātus/recuperātus - върнат, възстановен
ēpōtus - изпит, изгълтан
ēmancipātus - освободен, еманципиран
neglēctus - безпризорен, пренебрегнат, изоставен, презрян
requīsitus - търсен, желан, необходим, изискван, изискуем
exhibitus - представен, показан, предоставен
cōnātus - опитан, пробван
fascinātus - очарован, омагьосан, обладан
  effascinātus - очарован, омагьосан, обладан
replētus - попълнен, допълнен, възстановен
profusus - изобилен, проснат, пропилян
perterritus - ужасѐн
  imperterritus - безстрашен, неустрашим
reservātus - заделен, запазен, резервиран
cautus - предпазлив, бдителен, който е нащрек, внимателен, предвидлив, далновиден
  incautus - непредпазлив, небрежен, неподозиращ, невнимателен, неочакван, непредвиден
parātus - подготвен, осигорен
  imparātus - неподготвен
coctus - сготвен
  sēmicoctus - полусготвен
situs - позволен, разрешен, поставен, погребан, построен
asperātus - загрубен
  exasperātus - зарубен, нагрубен, раздразнен
obstinātus - упорит, решен, непоколебим, твърд, непреклонен
moderātus - умерен, трезв, сдържан, смекчен, управляван
  immoderātus - неумерен, краен (за нрав), необуздан, прекомерен, безмерен, безкраен
oblectātus - развеселен, зарадван
obsessus - обсаден, населен
ērudītus - образован, ерудит
stipulātus - обещан
astipulātus - обещан, потвърден, утвържден, съгласен
persuāsus - убеден
suāsus - препоръчан
iussus - заповядан, нареден, повелен
adhaerēns - долепен, прилепен, провлачен
obstrūctus - зазидан, барикадиран, блокиран, препречен
mūnītus - предпазен, обсипан, облепен, осейван, осяван
  commūnītus - укрепен, барикадиран
labefactus - отслабен, разхлабен, разхайтен, съборен, разрушен
sēdātus - успокоен, укротен, приключен
benefactus - благословен, спомогнат, оползотворен
malefactus - увреден, наранен
excerptus - избран, подбран
castīgātus - укорен, упректан, порицан, наказан, поправен
angulātus - ъглест
corrēctus - изправен, поправен, подобрен, заздравил се, коригиран
lūminātus - светъл, ярък
vetitus - забранен
  praevetitus - предварително забранен
medicātus - излекуван, на лекарство, боядисан
  praemedicātus - предпазен от болест чрез медицина или амулет
fictus - мним, престорен, преиначен, изопачен, измамен, лъжлив, фалшив
lectus - четен, прочетен, изчетен
  illectus - непрочетен, небран, несъбран
clīnātus - наклонен
mānsuētus/mānsuēs - питомен, укротен, смекчен
exolētus - израстнал, изхабен, износен, изтощен
plumbātus - споен, заварен
expertus - опитен, опитан, изпитан, доказан
comitātus - придружен
  concomitātus - придружен
dīvulgātus - разпространен, обикновен
continuātus - свързан, продължен, последователен, пореден, съседен, безспирен, вечен
disciplīnātus - обучен, дисциплиниран
aemulātus - подражаван, наподобен
nōminātus - именован, назован, кръстен, номиниран, обвинен
amātus - обичан, любим, харесван
dēpulsus - отблъснат, отстранен, изтласкан
impulsus - избутан, изтласкан, подтикнат, подчинен, съборен от власт
prōpulsus - тикан, подтикнат
repulsus - отхвърлен отблъснат, пободен в избори
interpellātus - прекъснат
commūnicātus - споделен, общ, съобщен
  excommūnicātus - отлъчен, анатемосан
prōmptus - разкрит, готов, решителен, бърз, използваем
  imprōmptus - неподготвен
pressus - натиснат, стиснат, подтиснат, кратък, точен
  pressulus - натиснатичък
  compressus - сдържан, удържан, прикрит, потиснат
tāctus - докоснат, барнат, допрян, достигнат, посигнат
  intāctus - недокоснат, небарнат, непокътнат, ненакърнен, недостигнат, непостигнат
trepidātus - трепетен, разтреперан от страх
īnfirmātus - отслабен, болен, изнурен (?), обезсилен, опроверган
damnātus - осъден, признат за виновен, изгнан
  condemnātus - осъден, признат за виновен, обвинен, преследван
  indemnātus - оневинен
perāctus - (за време) изминал/преминал, изпълнен, довършен, извършен, пробит, дразнен
interiectus - метнат между, поставен между, намиращ се между
ēlēctus - избран, отбран
probātus - изпитан, изпробван, доказан, приет, одобрен, приемлив
quiētus - тих, утихнал, спокоен, скромен, недеен,
haustus - точен, черпен, глътнат, пролят (за кръв), изчерпан
venditus - продаден
  invenditus - непродаден
māchinātus - измислен, изобретен
prōtractus - издърпан, удължен

moritūrus - заклет да умре, решен да умре
ausūrus - готов да дръзне, готов да рискува, усмеляващ се за бой
