esse - съм
  abesse - няма ме, отсъствам, нежелан съм
  adesse - присъствам
  adesse (+dat) - помагам (някому), присъствам, посещавам
  coesse - осъществен/сполучен съм
  coesse (+dat) - случвам се заедно (с), съществувам съвместно/едновременно (с)
  deesse - липсвам, отсъствам, занемарявам
  deesse (+dat) - не помагам (някому), нуждая се (от нещо)
  inesse - съм в, поместен съм в
  interesse - съм между, намирам се между, разграничавам се, отличавам се
  interesse (+dat) - присъствам
  interesse (imp) - има разлика, има значение
  praeesse - управлявам, ръководя
  posse - мога
  prōdesse (+dat) - в полза съм (на), спомагам (за), печеливш съм (за), облагодетелствам (нещо)
  subesse - съм под, намирам се под
  superesse - надживявам, оставам, оцелявам, живея, в повече съм
ēsse/edere, edisse, esum - ям
  comēsse/comedere, comedisse, comesum/comestum - изям

velle - искам
  nōlle - не искам
  mālle - предпочитам

fierī - бивам, случва се, сбъдва се, създава се, подготвя се
  collabefierī - падам, разпадам се, свален съм от власт
fore - ще стане

ferre, tulisse, lātum - нося, понасям
  afferre, attulisse, allātum - донасям
  auferre, abstulisse, ablātum - отмъквам, отнасям, прокуждам, убивам
  circumferre, circumtulisse, circumlātum - нося около, разгласявам
  cōnferre - стягам, събирам, обсъждам
  cōnferre sē - движа се
  dēferre - занасям, продавам, препредавам
  differre, distulisse, dīlātum - разнасям, забавям
  efferre - изнасям, обявявам
  īnferre - внaсям, погребвам, поставям, забивам, въвеждам, навлизам
  īnferre sē - вклинявам се, забивам се
  inferre (+dat) - причинявам (някому)
  offerre, obtulisse, oblātum - предлагам
  praeferre - предпочитам, нося пред себе си
  perferre - издържа, изпълнявам, понасям
  prōferre - извадя, извеждам, изговарям
  referre, rettulisse, relātum - връщам, отвръщам, препращам, донасям/предавам (новина, вест)
  trānsferre - пренасям, използвам преносно, нося в шествие, преписвам, превеждам, отлагам, преобразувам

īre eō, īisse/īvisse, itum - пътувам, движа се
  abīre - тръгвам
  adīre - идвам, захващам се с, допитвам се до някого
  anteīre (+dat) - ходя пред някого
  circumīre - обикалям, заобикалям
  coīre - срещам, събирам, пасвам, правя секс
  exīre - излизам
  inīre - встъпвам, почвам
  interīre - чезна, губя се, руша се, умирам
  introīre - влизам
  obīre - отивам си, умирам
  perīre - да умре, да се унищожи, да се разпадне
    disperīre - измирам, изчезвам, разпадам се, разрушавам се
  praeīre (+dat) - предхождам, предшествам, предвождам
  praeterīre - подминавам, минавам край нещо/някого, преминавам, надминавам, пренебрегвам
  prōdīre - придвижа се, приближавам
  quīre - умея, мога
    nequūre - не умея, не мога
  redīre - връщам се
  subīre - движа се под
  trānsīre - преминавам
  vēnīre - продаван съм
