revertī, reversum esse/revertisse (d) - връщам се


-spicārī (specī)]
  cōnspicārī (d) - забелязвам, възприемам
  suspicārī (d) - подозирам, предполагам


mentīrī (d) - лъжа
cōnārī (d) - опитвам се, прибвам
tumultuārī (d) - вдигам олелия, правя суматоха, всявам смут, обърквам, разбърквам
nāscī, nātum esse(d) - раждам се
morī -ior, mortuum esse (d) - умирам
  ēmorī -ior (d) - измирам, изчезвам
versārī (d) - въртя се, неспирно се движа
fatērī, fessum esse (d) - потвърждавам, признавам
  cōnfitērī (d) - признавам
orīrī, ortum esse (d) - изгрявам, появявам се
  coorīrī (d) - изниквам
  oborīrī (d) - появявам се повторно
precāri (d) - умолявам, прося
fruī, fructum/fruitum esse (d) (+abl) - радвам се на, удовлетворява ме, наслаждавам се на
tuērī, tutum/tuitum esse (d) - закрилям
lābī, lāpsum esse (d) - падам, хлъзгам се
  collābī (d) - гътвам
  dēlābī (d) - падам от, изпускам се
  ēlābī (d) - изпадам, изхлъзвам се, изплъзгам се
  prōlābī (d) - разпадам се
experīrī (d) - откривам, тествам, доказвам, опитвам, пробвам
minārī (d) (+dat) - заплашвам, действам страшно
minitārī (d) (+dat) - заплашвам, представлявам опасност
reminīscī, - (!) (d) (+acc) - спомням си
reminīscī, - (!) (d) (+gen) - да внимавам за нещо, да имам нещо предвид
venārī (d) - ловувам, диря, преследвам
praedārī (d) - грабя, плячкосвам
epulārī (d) - пирувам
innitī, innixum esse (d + abl) - облягам се
blandīrī (d) - ухажвам, лаская, давам комплимент, очаровам
querī, questum esse (d) - оплаквам се, обжалвам
luctārī (d) - боря се, играя борба
mīrārī (d) - чудя се
  admīrārī (d) - учудвам се, уважавам
ōsculārī (d) - целувам
  exōsculārī (d) - разцелувам, силно съм привързан
mētīrī, mensum esse (d) - меря
gradī -ior, gressum esse (d) - стъпвам
  aggredī -ior, aggressum esse (d) - настъпвам, нападам, приближавам
  dīgredī -ior, dīgressum esse (d) - отстъпвам, тръгвам, заминавам, разделям се, развеждам се
  ēgredī -ior, ,ēgressus esse (d) - пристъпвам
  prōgredī -ior, prōgressus esse (d) - настъпвам, вървя напред
profīcīscī, profectum esse (d) - заминавам, тръгвам си
sequī, secutum esse (д) - следвам
  cōnsequī (d) - настигам, достигам, изпреварвам
  persequī (d) - преследвам
laetārī (d) - радвам се
verēri, veritum esse (d) - страхувам се
intuēri, intuitum esse (d) - виждам, гледам, обследвам
complectī, complexum esse (d) - прегръщам
circumplectī, circumplexum esse (d) - обгръщам, заграждам, прегръщам
cōnsōlārī (д) - утешавам
loquī, locutum esse (d) - говоря
  colloquī (d) - събеседвам, разговарям
  ēloquī (d) - изговоря
  prōloquī (d) - проговорарям, продумвам
cōnārī (д) - опитвам да
fārī, fātum esse (d) - разказвам, приказвам
arbitrārī (d) - реша, смятам, на мнение съм
rērī (d) - смятам, мисля, подозирам
comitārī (d) - придружавам
philosophārī (d) - философствам
causārī (d) - извинявам се, търся си извинение
tuērī (d) - обезопасявам, подсигурявам, защитавам
  intuērī, intuitum esse (d) - гледам, наблюдавам
patī, passum esse (d) - понасям, страдам
pollicērī, pollicitum esse (d) - вричам се, обещавам
ūtī, ūsum (d) (+abl) - ползвам, използвам
imitārī: (d) - подражавам
hortārī (d) - увещавам, придумвам, увещавам, скланям, подтиквам, подбуждам, хортувам, нахъсвам
  adhortārī (d) - придумвам
  dēhortārī (d) - раздумвам, разубеждавам
  exhortārī (d) - предумвам
fabulārī (d) - приказвам, разказвам
oblīvīscī, oblītum esse (d) - забравям, потъмнявам
proeliārī (d) - воювам, участвам в битка
cunctārī (d) - протакам, отсрочвам, отлагам
tuī, tuitum esse (d) - наблюдавам, гледам, гръжа се, поддържам
largīrī, largitum esse (d) - давам щедро, подкупвам
vagārī (d) - странствам, блуждая
  pervagārī (d) - разпространявам, скитам, обикалям
interpretārī (d) - интерпретирам, преформулирам, тълкувам, разталкувам, разяснявам, обяснявам
grātulārī (d) (+dat) - приветствам (някого), поздравявам (някого), благодаря (някому)
lavārī (d) - къпя се, мия се
mūtuārī (d) - заемам, взимам на заем
ūrāscī (d) - вбесявам се, разгневявам се
percontārī (d) - разпитвам, разследвам
opīnārī (d) - мисля, смятам, на мнение съм
morārī (d) - оставам, пребивавам, закъснявам, кибича
calumniārī (d) - набедявам, набеждавам, клеветя, хуля
iocārī (d) - забавлявам, разсмивам
testārī (d) - показвам, свидетелствам, завещавам
  antestārī (d) - призовавам в съда за показания
  attestārī (d) - потвърждавам, засвидетелствам
indignārī (d) - възмущавам се, презирам, смятам за недостойно
ōrdīrī, ōrsum/ōrditus esse (d) - почвам, заговарям, зареждам, започвам да тъка
  exōrdīrī, exōrsum/exōrditum esse (d) - започвам, начевам, всъпвам, въвеждам
cūnctārī (d) - колебая се, протакам, бавя се
venerārī (d) - почитам, тача
perīclitārī (d) - бедствам, в беда съм, застрашен съм
prōmerērī (d) - заслужавам, достоен съм
recordārī (d) - припомням, премислям
ōtiārī (d) - почивам си
nītī, nīsum esse (d) - бъхтя се, бачкам, боря се. съпротивлявам се
mōlīrī (d) - дерзая, подемам, предприемам усилено, запретвам се, подкачам
assentīrī (d) - потвърждавам, съгласявам се, признавам
peregrīnārī (d) - странствам, пътувам в чужбина, мигрирам
meditārī (d) - съсредоточавам се, обмислям, вглъбявам се, размишлявам, медитирам
medērī (d) - лекувам
sectārī (d) - следвам, ловувам
adsectārī (d) - преследвам, придружавам, подкрепям
vadārī (d) - призовавам в съда (???)
īrāscī, īrātum esse (d) - беснея, гневя се

-perīrī, -pertum esse - изживявам, пробвам,
  opperīrī, oppertun esse (d) - чакам, изчаквам
  experīrī, expertum esse (d) - пробвам, опитвам, изпитвам/изпробвам някого, преживявам, изпитвам, набюдавам
