dubitāre - съмнявам се
vērāre - казвам истината
cessāre - бездействам, въздържам се, почивам, върша по-малко
salvāre - спасявам
dēsperāre - отчайвам се
dōnāre - подарявам, дарявам
cēnāre - вечерям
gustāre - вкуся
vetāre, vetuisse, vetitum/vetatum - забранявам, не допускам
optāre - избирам, желая, предпочитам
properāre - бързам, забързвам се
ōrdināre - подреждам
saltāre - скачам, танцувам
parcāre, pepercisse/parsisse, parcitum/parsum - въздържам се
flagrāre - пламтя
gestāre - нося товар, нося облекло
cēlāre - крия, скривам
caelāre - резбовам, дялкам, дълбая, гравирам
calcāre - тъпча, стъпвам
iugulāre - коля, убивам чрез разрязване на врата
maturāre - съзрявам, забързвам, движа се прибързано
iterāre - повтарям
vagāre - странствам
vītāre - избягвам
tentāre - опитвам, подтиквам
ānxiāre - тревожа се, притеснявам се
spumāre - пеня
dissipāre - разпръсквам, унищожавам
abundāre (+abl) - стига ми, имам повече от достатъчно
damnāre - осъждам
mināre - заплашвам, бутам, водя животни
observāre - тача, почитам
satiāre - да достига, задоволява
vacāre - почивам
mandūcāre - дъвча, смилам, глозгам
propīnāre - вдигам тост, наздравица
iūrāre - заклевам се
kalāre - разхлабвам, оставам нещо да виси
cantāre - пея
pulsāre - удрям
verberāre - бия
numerāre - броя
salūtāre - поздравявам
imperāre - заповядвам, управлявам, властвам 
habitāre - живея, населявам
dēlectāre - задоволявам, развеселявам
ambulāre - ходя
intrāre - влизам
lacrimāre - сълзя, плача
lātrāre - лая, джавкам
ululāre - вия
bālāre - блея (издавам звук)
natāre - плувам
occultāre - скривам, покривам
sānāre - лекувам
aegrōtāre - боледувам, зле съм
palpitāre - удрям
mīlitāre - служа в армията, воювам
nōmināre - именовам, назовавам
illūstrāre - осветявам
hiemāre - зимувам, презимувам
purāre - пречиствам се (религиозно-обредно)
lavāre, lāvisse, lautum/lōtum/lavātum - мия, къпя
aestuāre - топло ми е, жега ми е
frīgerāre - изстивам
nāvigāre - плавам
gubernāre - управлявам, насочквам
iactāre - мятам, хваля се, фукам се, големя се
dictāre - чета на глас, диктувам
gȳrāre - въртя се, обикалям
postulāre - настоявам
nārrāre (+acc, dat) - разказвам (нещо) (някому)
rogitāre - попитам
negāre - отричам
negāre (+dat) - отказвам да дам
temperāre - смесвам, размеквам, въздържам се (вероятно идва от въздържание за пиене на чист, а само смесеноо вино?) 
ignōrāre - неосведомен съм, не зная, пренебрегвам, в неведение съм
necāre - убивам
arāre - ора
rigāre - поливам, напоявам
labōrāre - трудя се, работя
exīstimāre - преценявам, смятам
rēgnāre - царствам, управлявам
aestimāre - оценявам, преценявам
nūntiāre - оповестявам, съобщавам, осведомявам
līberāre (+abl) - освобождавам (от)
pōtāre, potāvisse, pōtum/potātum - пия
ēducāre - образовам, обучавам, отглеждам
rēmigāre - греба
armāre - въоръжавам
cōpulāre - свързвам, сдвоявам, обвързвам
fatīgāre - изморявам
vulterāre - ранявам
certāre - бия се, боря се, съревновам се
ōscitāre - зея, прозявам се
pīpiāre - пиукам
vindicāre - отмъстявам, извършвам вендета
temptāre - опитвам, изпробвам, подкупвам
tolerāre - понасям, издържам, търпя
vāstāre - опустошавам
fugāre - вкарвам в бягство, карам друг да побегне
sēdāre - сядам, успокоявам, утаявам, ограничавам
simulāre - преструвам се, симулирам
stuprāre - изнасилвам
praecipitāre - мятам. хвърлям
celebrāre - празнувам
creāre - сътворявам, създавам
laudāre - хваля, честитя, поздравявам
vulnerāre - ранявам
violāre - насилвам, обезчестявам, гавря се с, опозорявам
superāre - надвивам, превъзхождам
accūsārе (+gen) - обвинявам (в)
sacrificāre - жертвам
foedāre - загрозявам
siccāre - суша, източвам
anhēlāre - издъхвам
cogitāre - мисля, облислям, представям си
radiāre - излъчвам, грея
agitāre - движа бързо
ingemināre - повтарям
probāre - одобрявам, утвърждавам, потвърждавам, доказвам, позволявам
notāre - бележа, забележа, отбележа
fraudāre - мамя, лъжа
calcāre - стъпквам, настъпвам, смазвам, трамбовам
cremāre - овъглявам, изпепелявам, кремирам


-cūsāre (causā)
  accūsāre - обвинявам
  excūsāre - оправдавам
  recūsare - отказвам
-vāgīnāre (vāgīna)
  invāgīnāre - прибирам в ножница
  ēvāgīnāre - вадя от ножница

dare, dedisse, datum - давам
  addere, addidisse, additum - прибавям, увеличавам, вкарвам, закачам
  circumdare - обкръжавам, ограждам
  condere - създавам, сътворявам
  ēdere, edidisse, editum - издавам (книга), създавам, раждам, произвеждам
  perdere, perdidisse, perditum - унищожавам, разршавам
  prōdere, prōdidisse, prōditum - предавам (създавам образ), предавам (тайна), предавам (разказ)
  reddere, reddidisse, redditum - връщам
  trādere, trādidisse, trāditum - предавам, подавам
  vēndere, vēndidisse, vēnditum - продавам
    revēndere - препродавам
portāre - нося
  apportāre - донасям
  comportāre - нося, събирам
  exportāre - изнасям
  importāre - внасям
  praeportāre - пренасям
  reportāre - нося обратно, връщам, докладвам
pellāre - бутам, удрям, пъдя
  appellāre - назовавам
  interpellāre - прекъсвам (в разговор), попречвам
volāre - летя
  āvolāre - отлитам, втурвам се
  advolāre - долитам
  circumvolāre - кръжа
  ēvolāre - излитам, отлитам
  trānsvolāre - прелитам
  pervolāre - прелитам
  prōvolāre - летя напред, хуквам
servāre - предпазвам, защитавам, спасявам 
  perservāre - продължавам
ligāre - вризвам, сглобявам
  alligāre - завързвам, обвинявам, включвам
cruciāre  - мъча, измъчвам
  excruciāre - изтезавам, измъчвам
sīderāre - понасям болест
  dēsīderāre - желая, жалея
lacerāre - режа, унищожавам
  dīlacerāre - разкъсвам
stāre, stetisse, stātum - стоя, не мърдам, почивам
  adstāre, adstitisse - достоя, стоя в близост
  cōnstāre, cōnstitisse, cōnstātum - състоя се, струвам
  obstāre, obstitisse - препречвам, попречвам
  praestāre, praestetisse, praestātum - надминавам, участвам, доставям, отговорен съм, изпълнявам
amāre - обичам
  adamāre - жадувам, страстно обичам
donāre - подарявам
  condonāre - прощавам
levāre - дигам, олеквам
  ēlevāre - облекчавам, вдигам, подценявам, принизявам
dicāre, dicavisse, dicatum - посвещавам, показвам, назначавам
  praedicāre - обявявам
ōrāre - моля, прося, моля се
  adōrāre - почитам
  exōrāre - измоля, убеждавам
errāre - странствам, блуждая, шляя се
  aberrāre - отклонявам се, губя се, греша
cubāre, cubuisse, cubitum - лежа
  accubāre - възлягам, прилягам
  accumbere - сядам на масата (използва се глагола за лягам, т.к. римляните яли в прилегнало положение)
  recumbere - облягам се на легло 
iuvāre, iūvisse, iūtum - помагам, удовлетворявам
  adiuvāre - спомагам, подпомагам, подкрепям
rogāre - питам
  iterrogāre - питам, разпитвам
spectāre - гледам, наблюдавам
  exspectāre - чакам, очаквам
mōnstrāre - соча
  dēmōnstrāre - показвам, отбелязвам, доказвам
spīrāre - дишам, духам
  cоnspīrāre - заговорнича
putāre - смятам, вярвам, мисля, оценявам, изчиствам
  opputāre - режа, кастря
  perputāre - обяснявам подробно, подрязвам изцяло
pugnāre - бия се
  oppugnāre - нападам, атакувам, щурмувам
  expugnāre - завладявам, побеждавам в бой
  repugnāre - противоборя се
clāmāre - викам, извиквам
  exclāmāre - възкицавам
vocāre - викам, зова
  āvocāre - отзовава
  convocāre - свиквам
  invocāre - призовавам
  prōvocāre - предизвиквам, насъсквам, подстрекаванм, провокирам
  revocāre - призовавам обратно, приканвам повторно, викам някого да се върне
vigilāre - буден съм, бдя
  ēvigilāre - разсънвам се, събуждам се
signāre - означавам, отбелязвам, поставям знак
  obsignāre - подписвам
cōgitāre - мисля
  excōgitāre - измислям
turbāre - вълнувам, обърквам, обезпокоявам, предизвиквам, раздразням, стресвам, буня
  conturbāre - сбърквам, омешвам
  disturbāre - развълнувам, разбърквам
  perturbāre - шашардисам, слисвам, озадачавам
spērāre - надявам се
  dēspērāre - отчайвам се, губя надежда
secāre, secuisse, sectum - сека, режа
  consecāre - просичам, пресикам
  dissecāre - разсичам, разрязвам
  persecāre - разчленявам
propinquāre - доближавам
  appropinquāre - приближавам
ōrnāre - крася, украсявам
  exōrnāre - разкрасявам
parāre - готвя, подготвям, осигурявам
  comparāre - събирам, сравнявам
  sēparāre - разделям
memorāre - машпмням, припомням, споменавам
  commemorāre - споменавам 
firmāre - втвърдявам
  affirmāre - потвърждавам
plicāre - гъна, вия
  implicāre - сгъвам, увивам
vorāre - поглъщам, папам
  dēvorāre - нагълтвам, изгълтвам
plānāre - равнявам, заглаждам
  explānāre - разяснявам, изглаждам
cūrāre - грижа се за, бдя над, осигурявамм/издържам някого
  prōcūrāre - управляваам, ръководя
citāre - движа, вълнувам, буня
  concitāre - втурвам се, вълнувам, разбунвам
  excitāre - разсънвам, събуждам, развълнувам
  incitāre - забързвам, побутвам, разраствам, усилвам, въодушевявам
  recitāre - чета на глас, рецитирам
  suscitāre - събуждам, възбуждам
plōrāre - рева, издавам вик, стена
  applōrāre - зарева
  complōrāre - съжалявам
  deplōrāre - оплаквам се
  explōrāre - откривам, изследвам, изпробвам
  implōrāre - моля, умолявам
  opplōrāre - изрева
fīrmāre - калявам, заздравявам
  affīrmāre - закалявам, подсилвам, изяснявам, потвърждавам
  cōnfīrmāre - закалявам, насърчавам, потвърждавам
locāre - местя, слагам, подреждам
  collocāre - съвместявам 
novāre - освежавам, опресняявам, променям
  renovāre - подновявам, възстановявам, реновирам
ministrāre - обслужвам, доставям, слугувам
  administrāre - поддържам, управлявам, насочвам
migrāre - преселвам се, местя се, мигрирам
  admigrāre - приобщавам се
  cōnmigrāre - вселявам се
  dēmigrāre - заминавам, тръгвам си
  ēmigrāre - изселвам се, емигрирам
  immigrāre - заселвам се, имигрирам
  remigrāre - връщам се
  trānsmigrāre - премествам се
mūtāre - меня, променям, заменям, обменям
  commūtāre - сменям, заменям, разменям
flāre - духам
  effāre - издухвам
sonāre - звуча
  adsōnare (+dat) - съзвуча
  resonāre - звуча повторно
tenuāre - намалям, изхабявам, износвам
  attenuāre - отслабвам, отслабя
  extenuāre - изтъня, намаля, вталя
versāre - въртя, бъркам, маневрирам
  āversāre - отбягвам, отгазвам
