reperīre,repperisse, repertum - изобретя, намеря, получа
oboedīre - подчинявам се
īnsidīre, īnsidiavisse - чакам в засада, заговорнича, поставям клопка, внимавам
invadīre - навлизам, отнемам
invadīre in - нападам
condīre - запазвам, балсамирам, мумифицирам, подправям, мариновам
partuīre - бременна съм
fastīdīre - не понасям, ненавиждам, отвращавам се от нещо, презирам, пренебрегвам
sitīre - жаднея, жадувам
ēsurīre - гладувам
vestīre - обличам
pūnīre - наказвам, отмастявам
vāgīre - цивря
vincīre, vinxisse, vinctum - задържам, оковавам
cūstōdīre - охранявам, закрилям, защитавам, пазя
mollīre - размеквам
servīre (+dat) - подчинявам се, робувам
mūnīre - укрепвам
ērudīre - образовам, насочвам, възпитавам
nūtrīre - храня, захранвам, подхранвам, кърмя[, бозая, суча, цоцам ???]
sepelīre, sepeliisse/sepelivisse, sepultun - погребвам, заравям, потапям, потискам, унищожавам
mūgīre, mūgivisse - муча
īnsānīre - откачен съм
sarcīre - възстановявам, поправям, кърпя
polīre - лъскам, шлифовам, лакирам, полирам
garrīre - плямпам, дрънкам, дърдоря
lēnīre, līvisse/liisse, lītum - утешавам, успокоявам, облекчавам, смекчавам, омекотявам, отслабвам
ferīre - сека, посичам, сека монети, удрям, убивам, сключвам договор/сделка
tinnīre - звънча
superbīre - надменен съм, показвам своята надменност
saevīre - свирепея
sortīre - тегля клечка (в смисъл на жребий)
amicīre - обличам, намятам, покривам, ограждам, воалирам
sitiīre - жаднея

-pedīre [pēs]
  impedīre - забавям, възпрепятствам, преча, попречвам
  impedīre (+dat) - вредя (някому)
  expedīre - забързвам
  expedīre (+dat) - помагам (някому)

-perīre, -peruisse, -pertum
  aperīre, aperuisse, apertum - отварям, разкривам, оповестявам, разкопавам
  operīre, operuisse, opertum - покривам, прикривам


salīre, sаluisse/saliisse, saltum - скачам, хвърлям се
  circumsilīre. circumsiluisse - подскачам
  dēsilīre, dēsiluisse - скачам
  exsilīre, exsiluisse - изскачам
  īnsilīre, īnsiluisse - нахвърлям се
  prōsilīre - скачам напред
  trānilīre - прескачам
dormīre - спя
  obdormīre - заспивам
venīre, vēnisse, ventum - идвам, стигам
  advenīre - пристигам
  circumvenīre - обграждам, окръжавам, опасвам
  convenīre - събирам се (обикновено в множествено число), съдя/призовавам в съда, съгласувам, договарям
  covenīre (imp) (+dat, īnf) - пасвам, подхождам, ставам
  dēvenīre - достигам, приземявам се, спускам се, слизам
  ēvenīre - случвам се, сбъдвам се
  invenīre - откривам
  obvenīre - срещам, случвам се
  pervenīre - стигна, достигна
  prōvenīre - пристигам, настъпвам, появявам се
  revenīre - връщам се
haurīre, hausisse, haustum - точа, празня
  exhaurīre - източа, изпразня, изсуша, пия до дъно
audīre - чувам
  exaudīre - дочувам
fīnīre - ограничавам, приключвам, свършвам, довършвам
  dēfīnīre - ограждам, определям, уточнявам, задържам
sentīre, sēnsisse, sēnsum - усещам, чувствам, на мнение съм
  dissentīre - в разногласие съм с
  cōnsentīre - съчувствам, на едно мнение съм с някого, съдействам, съгласявам се
  praesentīre - предусещам, предсещам, предчувствам
scīre - зная, разбирам
  praescīre - предзная, прозирам, предвиждам, знам предварително
flīgere - блъскам
  afflīgere - блъскам, бия, ранявам, повреждам
  cōnflīgere - сблъскам, водя бой/битка
  prōflīgāre - побеждавам главоломно
līnīre - мажа, помазвам, покривам
  dēlīnīre - успокоявам, укротявам, размеквам, очаровам
pertīre - деля, споделя, разделя
  impertīre - споделя, предавам, дарявам
