simplus - единичен, прост, семпъл
duplus - двоен
triplus - троен
quadruplus - четворен
quīnquiplus/quīntuplus/quīncuplus - петорен
sextupulus/sexuplus/sexcupulus - шесторен
septuplus - седморен
octuplus/octōplus - осморен
nōnuplus/nocuplus/nuncuplus/nōnecuplus/novemcuplus/novecuplus/novemplus - деветорен
decuplus/decemplus - десеторен
ūndecuplus/ūndecemplus/ūndecimplus - единайсеторен
duodecuplus/duodecemplus/duodecimplus - дванайсеторен
terdecuplus/trēdecuplus - тринайсеторен
quattuordecuplus - четиринайсеторен
quīndecuplus - петнайсеторен
sēdecuplus/sexdecuplus/sesdecuplus - шеснайсеторен
septemdecuplus - седемнасеторен
duodēvīgecuuplus - осемнайсеторен
ūndēvīgecuuplus - деветнайсеторен
vīgecuplus/vīcecuplus/vigincuplus - двайсеторен
trīgecuplus/trīcecuplus/trigintuplus - трийсеторен
quadrāgecuplus/quadragintuplus - четирийсеторен
quīnquāgecuplus - петдесеторен
sexāgecuplus - шейсеторен
septuāgecuplus - седемдесеторен
octōgecuplus - осемдесеторен
nōnāgecuplus - деведесеторен
centuplus/centumplus - стоторен
ducentuplus - двестаторен
trecentuplus - тристаторен
quadringentuplus - четиристотинторен
quīngentuplus - петстотинторен
sescentuplus - шестстотинторен
septingentuplus - седемстотинторен
octingentuplus - осемстотинторен
nōngentuplus - деветстотинторен
mīllecuplus/mīlletuplus/mīllimodus - хилядаторен
