tam - толкова
quam - колкото
tot - толкова
quot - колкото
tantus - толкова голям
quantus - колкото голям
tantum - толкова много
quantum - колкого много
tamdiū - толкова дълго
quamdiū - колкото дълго
tantundem - също толкова, точно колкото
amplius - повече
saltem - поне, толкова
pariter - поравно, заедно

nōn - не
haud - не, хич не
absque - без
vērum - наистина
ideō - затова, заради това
idcircō - затова, поради тази причина
proptereā - затова, заради това
quāpropter - защо, заради какво
iūre - редно
rēctē - правилно
vērē - истинно
etenim - и наистина

potius - по-точно, по-скоро, по-удачно, за предпочитане, даже, може би
frūstrā - напразно, неуспешно
praetereā - също така, още повече, между другото, насетне
forte - случайно, по случайност
tamen - все пак
certē - със сигурнос
profectō - със сигурност
maximē - много,особено, главно
minimē - хич, никак, ни най-малко
scīlicet - естествено, разбира се, всезнайно е, знае се че, ясно е
fortasse - може би, вероятно, възможно
forsitan - може би, вероятно
cēterum - а пък, освен това
quidem - навярно, определено
equidem - аз пък, аз обаче
nē ... quidem - дори не
paene - почти, в близост
... causā - с цел да, заради, че да
parum - твърде малко, недостатъчно
sānē - опредеделено, със сигурност
aliquantum - все няакакви, немалко, донякъде, някакъв брой, някакво количество
nimium - предостатъчно, твърде много
funditus - до дъно, изцяло, коренно
utinam - дано
praecipuē - особено
dumtaxat - сано, единствено, тъкмо, тамън
plērumque - обикновено, по принцип, почти винаги

libenter - с удоволствие, със щастие
iūre - заслужено, наистина
cōmiter - добронамерено, добродушно
ācriter - ожесточено, силно, жизнено
strenuē - храбро
clam - тайно, подмолно, скрито
aegrē - трудно
valdē, magis, māximē - силно, здраво
incondonābile - непростимо
citō - бързо, скоростно, срочно
vicem - вместо, в следствие на
invicem - съвместно, един другиго
perītē - изкусно
circiter - около, приблизително
vehementer - изключително, жизнено
impūnē - ненаказано
certātim - бойно
ultrō - доброволно, допълнително
opportūnē - в удобно време, в подходящно време
meritō - заслужено

quasi - като, като че, подобно на
sīc - така, тъй
ita - онака
sīcut - като че, като, както
itidem - също, по същия начин
item - също, по същия начин
aliter - иначе, инак, другак, другояче
tamquam - тъй както, все едно, като че
velut - като че, като да, все едно

ubīque - навсякъде
passim - вред, навред, вредом, всъде
nusquam - никъде
usquam - някъде, по накакъв начин, но винаги се използва с отрицание за получаване на никъде, хич
utrōque - от двете страни
ubīcumque - където и да е
quācumque - където и да е, както и да е, по какъвто и да е начин
undecumque - откъдето и да е, отвсякъде, по всякакъв начин, всевъзможно
cōram - лице в лице, в присъствието на, пред
penitus - далеч
undique - отвсякъде
prope - близо, близко
propius - по-близо, по-близко
procul - далеч, далеко
longē - далеко
longulē - далеко
inde - откъдето
hic - тук
ibi - там, където
illic - там
hūc - насам
eō - натам, накъдето
illūc - натам
hinc - оттук
inde: - оттам, откъдето
illinc - оттам
intus - вътре
forās (+acc) - (в посока) навън
forīs (+abl) - (на място) навън
sūrsum - нагоре
deorsum - надолу
citrā - от тази страна
ultrā - от другата страна
aliō - другаде, надругаде, към друго място
retrō - обратно, наобратно
peregrē - от/в чужбина
quātenus - докъде

galliciniō - по първи петли
māne - сутрин
vesperi - вечер
hodiē - днес
cotīdiē - всеки ден
herī - вчера
prīdiē - през предишния ден
crās - утре
postrīdiē - на следващия ден
noctū - нощно, през нощта, нощес
interdiū - дневно, през деня
quotannīs - всекигодишно, ежегодишно


prīmō - първо
prīmum -първо
prius - първо, в първо време
prius (+abl) - преди (някого)
initiō - за начало
simul - едновременно, по същото време
ūnā cum (+abl) - едновременно с, заедно с,  в/по едно и също време
dein - после, след това
deinde - после, след това
exim - после, впоследствие, подир
dēnique - накрая
dēmum - най-сетне, най-накрая, разгеле, съвсем точно
tandem - накрая, най-накрая


adhūc - засега, досега
anteā - преди това, преди, едно време
antehāc - досега, дотук (за време)
post - след
posteā - след това, после, след време
posthāc - отсега, натам (за време), оттук натам (за време)
postillāc - насетне, оттогава, нататък (за време)

statim - веднага, на момента
continuō - немедлено, тутакси, веднага, завчас
prōtinus - веднага, немедлено
subitō - внезапно, изневиделица
repente - изведнъж, тутакси
paulātim - мудно, протакано, постепенно


semper - винаги
tunc - тогава
prīdem - одавна
ōlim - веднъж, едно време
quondam - едно време, преди
recēns - скоро, наскоро
nōndum - все още не, засега не
nūper - скоро, наскоро, преди малко
iam - вече, сега (вече нещо се е случило, нещо е така)
optimē - точно навреме
modo - тамън, тъкмо
dūdum - тамън, тъкмо
nunc - сега (нещо се случва)
etiamnunc - дори сега
mox - скоро, след малко
brevī - след малко, скоро
diū, diūtius, diūtissimē - задълго
paulisper - закратко
inde ab (+abl) - откакто
donec - докато
ūsque - все, винаги, изцяло
ūsque ad (+acc) - докато, чак до
temperī, temperius - навреме
sērō - със закъснение, по-късно
interim - в това време
intereā - по същото време
quandōcumque - когато и да е
aliquandō - някога, все някога, по някое време
quondam - някога
dōnec - докато, доколкото

satis - достатъчно
nimis - прекалено, предостатъчно
vix - едвам
tantum - само
ferē - около, горе-долу, почти
dumtaxat - само, единствено, точно
funditus - напълно, изцяло
adeō - дотолкова, точно
omnīnō - напълно, изцяло
sōlum - само, единствено
modo - само, едиствено
aliquot - няколко

singulātim - един по един, една по една, едно по едно, отделно
umquam - някога, но винаги се използва с отрицание за получаване на никога
saepe, saepius, saepissimē - често
nōnnumquam - нерядко, доста често
interdum - отреме-навреме
rārō, rārius, rārissimē - рядко
toliēs - толкова пъти
rūrsus - отново, повторно
iterum - пак, повторно, отново
dēnuō - наново
semel - веднъж
bis - дваж, дважди, два пъти
ter - триж, трижди, три пъти
tertiō - триж, трижди, три пъти
tertium - триж, трижди, три пъти
quatter - четири пъти
quīnquiēs - пет пъти
sexiēs - шест пъти
septiēs - седем пъти
octiēs - осем пъти
noviēs - девет пъти
deciēs - десет пъти


quālis - какъв
quotiēs - колко пъти
quot - колко (на брой)
quantī - колко (на брой)
quantae - колко (на брой)
quanta - колко (на брой)
quantum - колко (интензивно), какво количество
quandō - кога, когато
ubi - къде, където
unde - откъде, от какво
quō - накъде
cūr - защо
quid - защо
quidnī - защо не
quāre - защо
quamobrem - защо, заради какво, каква е причината
quōmodo - как, както
quī - как
num - ли (очаква се отрицателен отговор)
nōnne - не е ли (очаква се положителен отговор)
quīn - защо не
hicine - тови ли
haecine - тази ли
hocine - това ли
sōdēs - ако обичаш, ако можеш


bene, melius, optimē - добре
male, pēius, pessimē - зле

facile - лесно
difficile - трудно
temere - плашливо

ācriter - сурово
alacriter - с удоволствие
animōsē - жизнено
attentē - внимателно
avidē - алчно
iniūste - несправедливо, нередно, нечестно
miserābiliter - съчувствено
grātuītō - благодарно
graviter - тежко, насилствено
falsō - невярно, лъжливо
ferōciter - диво
fortiter - смело
saevē - свирепо
sevērē - строго, сурово
superbē - надменно
perversē - извратено
probē - правилно, добре
iūstē - справедливо, редно, законно
inūstē - несправедливо, нередно, безправно
rectē - правилно, точно, добре
turpiter - противно, отвратително, безсрамно, грозновато
lentē - бавно, мързеливо, мудно
cōpiōsē - изобилно
occultē - тайно, скрито, прикрито
apertē - известно, ясно, открито
ūnicē - особено
aequē - равно, еднакво
sēdulō - усърдно
mātūrē - навреме, навременно
mendāciter - лъжливо, грешно
novissimē - накрая
simpliciter - просто, набързо, накратко
obstinanter - инатливо, решено
