tam - толкова
quam - колкото
tot - толкова
quot - колкото
tantum - толкова много
quantum - колкото много
tamdiū - толкова дълго
quamdiū - колкото дълго
tantundem - също толкова, точно колкото
totidem - толкова на брой, същия брой, равнобройно
amplius - повече, още, (за количество) над
saltem - поне, толкова
pariter - поравно, еднакво, заедно
tantopere - дотолкова, толкова силно, толкова много, тъй много

quasi - като, като че, подобно на
sīc - така, тъй
ita - онака
sīcutī/sīcut - като че, като, както, сякаш
itidem - също, по същия начин
item - също, по същия начин
aliter - иначе, инак, другак, другояче
tamquam - както, тъй както, все едно, като че, сякаш
velut - като че, като да, все едно, комай
tantummodo - едвам, все някак
tantum - дотолкова
ēiusdemmodī/ēiusmodī - от този вид, по този начин
prout - точно както, според, съответно, в съответствие с
perinde - тъй както, еднакво

aequē - равно, еднакво
adaequē - равно, приравнено, подобно на
aequiter - подобно на, също толкова, по същия начин
