quālis - какъв
quotiēs - колко пъти
quot - колко (на брой)
quantī - колко (на брой)
quantae - колко (на брой)
quanta - колко (на брой)
quantum - колко (интензивно), какво количество
quandō - кога, когато
ubi - къде, където
ubinam - че къде
unde - откъде, от какво
quō - накъде
quātenus - докъде, докога, доколко
cūr - защо
quid - защо
quidnī - защо не
quārē - защо, как
quamobrem - защо, заради какво, каква е причината
quōmodo - как, както
quī - как
ut - как
num - дали, ли (очаква се отрицателен отговор)
nōnne - нали, не е ли (очаква се положителен отговор)
numquid - как така? (очаква се отрицателен отговор), вярно ли?
ecquid - дали, изобщо ли
quīn - защо не
hicine - тови ли
haecine - тази ли
hocine - това ли
sōdēs - ако обичаш, ако можеш
quōrsum - накъде, с каква цел
