quā - където, по който
ubīque - навсякъде, къде да е
passim - вред, навред, вредом, всъде
nusquam - никъде
usquam - някъде, някак си, но винаги се използва с отрицание за получаване на никъде, хич
utrōque - от двете страни
ubīcumque - където и да е
quācumque - където и да е, както и да е, по какъвто и да е начин
undecumque - откъдето и да е, отвсякъде, по всякакъв начин, всевъзможно
ubicumque - навсякъде, където и да е
quōcumque - навсякъде
cōram - лице в лице, в присъствието на, пред
incōram - открито, пред
praestō - налице, в готовност
penitus - навътре, отвътре, вътрешно, далеч
undique - отвсякъде
utrimque - от двете страни
utrobīque/utrubīque - на двете места, на двете страни

procul - далеч, далеко
longē - далеко/далеч/далече (за разстояние), далече (много повече), далече (много време)
longulē - далекичко, далечко
longinquē - далече (за разстояние), далече (много време), след много време
longiter - далече
longiusculē - далекичко, дългичко (за пространство и време)

hīc - тук
istīc - там, при слушателя/читателя
ibi - там, където
ibīdem - на същото място, пак там
illīc - там
alibī - другаде
aliās - другаде

hūc - насам
istūc - натам, към слушателя/читателя
eō - натам, накъдето
eōdem - натам, към същото място
illūc - натам
aliō - надругаде
quōquō - накъдето и да е
quōcumque - накъдето и да е

hinc - оттук
istinc - оттам, от слушателя/читателя
inde - оттам, откъдето
illinc - оттам
aliunde - отдругаде

hāc - така, насам
istāc - онака, както слушателя/читателя; там, при слушателя/читателя
eā - натам
illāc - онака, натам
hāctenus - дотук, досега, дотолкова
aliā - другак

intus - вътре
intrōrsum - навътре, вътре
dē intrō - отвътре
forīs (+abl) - (на място) навън
forās (+acc) - (в посока) навън


sūrsum - нагоре
supernē - нагоре
deorsum - надолу
īnfrā - надолу
citrā - от тази страна
ultrā - от другата страна
aliō - другаде, надругаде, към друго място
retrō - обратно, наобратно, назад
ante - напред
post - назад
peregrē - от/в чужбина
quātenus - докъде
obviam - къмто, към, по посока на, срещу (в движение)

cavernātim - през пещера
prōpatulō - под открито небе
