singulātim - един по един, една по една, едно по едно, отделно
umquam - някога, но винаги се използва с отрицание за получаване на никога
nōnnumquam/nōnnunquam - нерядко, доста често
interdum - отреме-навреме
toliēs - толкова пъти
rūrsus - отново, повторно
iterum - пак, повторно, отново
identidem - отново и отново, пак и пак
dēnuō - наново
semel - веднъж
bis - дваж, дважди, два пъти
ter - триж, трижди, три пъти
tertiō - триж, трижди, три пъти
tertium - триж, трижди, три пъти
quater - четири пъти
quīnquiēs - пет пъти
sexiēs - шест пъти
septiēs - седем пъти
octiēs - осем пъти
noviēs - девет пъти
deciēs - десет пъти
ūndeciēs - единадесет/единайсет пъти
duodeciēs - дванадесет/дванайсет пъти
ter deciēs - тринадесет/тринайсет пъти
quater deciēs - четиринадесет/четиринайсет пъти
quīnquiēs deciēs - петнадесет/петнайсет пъти
sexiēs deciēs - шестнадесет/шестнайсет пъти
septiēs deciēs - седемнадесет/седемнайсет пъти
duodēvīciēs - осемнадесет/осемнайсет пъти
ūndēvīciēs - деветнадесет/деветнайсет пъти
vīciēs - двадесет/двайсет пъти
trīciēs - тридесет/трийсет пъти
qua­drā­­giēs - четиридесет/четиресет пъти
quīnquāgiēs - петдесет пъти
sexāgiēs - шестдесет/шейсет пъти
septuāgiēs - седемдесет пъти
octōgiēs - осемдесет пъти
nōnāgiēs - деветдесет пъти
centiēs - сто пъти
ducentiēs - двеста пъти
trecentiēs - триста пъти
quadringentiēs - четиристотин пъти
quīngentiēs - петстотин пъти
sexcentiēs - шестстотин пъти
sepingentiēs - седемстотин пъти
octingentiēs - осемстотин пъти
nōngentiēs - деветстотин пъти
mīliēs - хиляда пъти
bis mīliēs - две хиляди пъти
