nōn - не
haud - не, хич не
vērum - наистина
ideō - затова, заради това
ideōque - та затова, и така, и тъй
idcircō - затова, поради тази причина
īnsuper - впрочем, допълнително, в допълнение, още повече, отгоре
praetereā - прочее, също така, още повече, между другото, насетне
praeterquam - освен това, допълнително, не само
propter - заради, чрез
proptereā - затова, заради това
quāpropter - защо, заради какво
iūre - редно
etenim - и наистина
nē ... quidem - дори не
utinam - дано, де да
velim - дано, де да, ще ми се
... causā - с цел да, заради, че да
tamen - обаче, въпреки това, но все пак
attamen - но въпреки това
vērumtamen - но въпреки това
nihilōminus - въпреки това, макар че, макар да
cēterum - а пък, освен това
equidem - по мое мнение, според мен, аз пък, аз обаче, за мен
vicem - вместо, в следствие на
invicem - съвместно, един другиго
unde - откъдето, в следствие на което
utpote - че да може
quippe - би трябвало, с оглед на, сигурно, именно
quamvīs - колкото ще
quamvīs (+coni) - въпреки че
imprīmis - най-вече, главно
inde - откъдето, следователно
proinde - тъй че, откъдето, следователно
ergō - следователно, затова
admodum - достатъчно, напълно
quandōquidem - тъй като, с оглед на
multimodīs - по много начини
mīrimodīs - по чуден начин

gnerātim - обикновено, в общност
speciātim - особено, в частност
