singulī - един по един, по едно, по единици
ūnī - един по един, по едно, по единици (използва се за чисто множествени съществителни)
bīnī - два по два, по две, по двойки
ternī - три по три, по три, по тройки
trīnī - три по три, по три, по тройки (използва се за чисто множествени съществителни)
quaternī - чретири по четири, по четири, по четворки
quīnī - пет по пет, по пет, по петици
sēnī - шест по шест, по шест, по шестици
septēnī - седем по седем, по седем, по седмици
octōnī - осем по осем, по осем, по осмици
novēnī - девет по девет, по девет, по деветки
dēnī - десет по десет, по десет, по десетки
ūndēnī - единайсет по единайсет, по единайсет, по единайски
duodēnī - дванайсет по дванайсет, по дванайсет, по дванайсет
ternī denī - тринайсет по тринайсет, по тринайсет, по тринайски
quaternī denī - четиринайсет по четиринайсет, по четиринайсет, по четиринайски
quīnī dēnī - петнайсет по петнайсет, по петнайсет, по петнайски
sēnī denī -  шестнайсет по шестнайсет, по шестнайсет, по шестнайски
septēnī denī - седемнайсет по седемнайсет, по седемнайсет, по седемнайски
duodēvīcēnī - осемнайсет по осемнайсет, по осемнайсет, по осемнайсски
ūndēvīcēnī - деветнайсет по деветнайсет, по деветнайсет, по деветнайски
vīcēnī - двайсет по двайсет, по двайсет, по двайски
trīcēnī - трийсет по трийсет, по трийсет, по трийски
quadrāgēnī - четирийсет по четирийсет, по четирийсет, по четирийски
quīnquāgēnī - петдесет по петдесет, по петдесет, по петдесетки
sexāgēnī - шестдесет по шестдесет, по шестдесет, по шестдесет
septuāgēnī - седемдесет по седемдесет, по седемдесет, по седемдесет
octōgēnī - осемдесет по осемдесет, по осемдесет, по осемдесетки
nōnāgēnī - деветдесет по деветдесет, по деветдесет, по деветдесетки
centēnī - сто по сто, по сто, по стотачки
duocēnī - двеста по двеста, по двеста, по двестатачки
trecēnī - триста по триста, по триста, по тристачки
quadringēnī - четиристотин по четиристотин, по четиристотин, по четиристотачки
quīngēnī - петстотин по петстотин, по петстотин, по петстотачки
sescēnī - шестстотин по шестстотин, по шестстотин, по шестстотачки
septingēnī - седемстотин по седемстотин, по седемстотин, по седемстоттачки
octingēnī - осемстотин по осемстотин, по осемстотин, по осемстотачки
nōngēnī - деветстотин по деветстотин, по деветстотин, по деветстотачки
singula mīlia - хиляда по хиляда, по хиляда, по хиляди
bīna mīlia - двехиляди по двехиляди, по двехиляди
