ācriter - сурово, ожесточено, силно, жизнено
alacriter - с удоволствие
animōsē - въодушевено, жизнено, храбро, безстрашно, устремено, агресивно, враждебно, гордо, гневно, възторжено, екстатично, радостно
attentē - внимателно
avidē - алчно
iniūste - несправедливо, нередно, нечестно
miserābiliter - съчувствено
grātuītō - благодарно
graviter - тежко, насилствено
falsō - невярно, лъжливо
ferōciter - диво
fortiter - смело
saevē - свирепо
sevērē - строго, сурово
superbē - надменно
perversē - извратено
probē - правилно, добре
iūstē - справедливо, редно, законно
inūstē - несправедливо, нередно, безправно
rectē - правилно, точно, добре
rectā (viā) - пряко
turpiter - противно, отвратително, безсрамно, грозновато
lentē - бавно, мързеливо, мудно
cōpiōsē - изобилно
occultē - тайно, скрито, прикрито
apertē - известно, ясно, открито
ūnicē - особено
sēdulō - усърдно
mendāciter - лъжливо, грешно
novissimē - накрая
simpliciter - просто, набързо, накратко
sēcrētō - тайно
strēnuē - пъргавo, трескаво, работливо
aegrē - трудно, с мъка, неохотно
dexterē - сръчно, умело
citō - бързо, скоростно, срочно
perītē - изкусно
impūnē - безнаказано
compressē - ожесточено, силно, жизнено
splendidē - бляскаво
amīcē - приятелски, приветливо
benignē - благосклонно, добронамерено, доброжелателно
acerbē - горчиво, сурово
piē - съвестно, праведно
commodē - баш, умело, грижливо, подходящо, учтиво
perfectē - съвършено, перфектно
importunē - губо, жестоко, непремерено
beātē - блажено, приятно, щастливо
torvē - плашещо, злобно, злокобно, свирепо
amātōriē - любовно
vānē - напразно, безцелно
concinnē - спретнато, красиво, щателно
inconcinnē - калпаво, непохватно, несръчно
pulchrē - хубаво, красиво
paulō - малко, по малко, донякъде
pauxillō - малко, по малко, донякъде
historicē - исторично
officiōsē - услужливо, отзивчиво
hērōicē - героично
fragōsē - чупливо, грубо, неравномерно
opiparē - гиздаво, богато, великолепно
vacīvē - ненапрегнато, спокойно
taetrē - отвратителнo, противнo, гаднo, гнуснo, отблъсквщo, мерзкo
profūsē - изобилно, прекомерно, наднормено, разточително, разхитително
mīrandē - чудно, чудесно, изумително
perniciōsē - разрушително, унищожително
integrē - изцяло, всецяло, напълно, вкупом, купом, накуп, безупречно
parcē - щадящо
vagē - на посоки, блуждаейки
lūcidē - ярко, бляскаво, ясно (светлина), ясно (разбираемо)
pūblicē - обществено, официално, на държавни разноски, отнасящо се цялостно до народа, публично
fictē - мнимо, измамно, фалшиво, изкуствено, лъжливо, преиначено, изопачено
idōneē - подходящо, удобно, годно, сгодно, уместно, целесъобразно, приемливо
iēiūnē - оскъдно, нищожно
prōnē - по корем, с наклон напред
prōlixē - протяжно, изобилно, безрезервно
cultē - изискано, изтънчено, финес
pressurē - натискайки
dīvīnē - божествено
ēlectē - отбрано, с вкус
properē - забързано, скоростно
internē - вътрешно
temerāriē - самонадеяно
quiētē - спокойно, тихом, тихомълком
mānsuētē - меко, спокойно, смирено, нежно
prōtractē - удължено
manifestō - очевидно, ясно, явно, несъмнено, безсъмнено, сигурно, неминуемо, отчетливо, на местопрестъплението
cōnsuētē - обикновено, както обикновено, по навик, по обичай
perfidē - вероломно, предателски
tacitē - мълчаливо, тихо, безмълвно, нямо
profundē - дълбоко
voluntāriē - волно, доброволно
generōsē - благородно, достойно
obscūrē - неясно, тъмно, потайно, неосезаемо, загадъчно
nervōsē - силно, енергично, жизнено
articulātē - разчленено, на части
praecīsē - набързо, накратно, сбито, стегнато
honōrificē - почето, почтитело
aptē - подходящо, подхождащо, подобаващо
luxuriōse - луксозно, разкошно, разточително, сладострастно
masculīnē - по мъжки
fēminīnē - по женски
dignē - достойно, заслужено
indignē - недостойно, възмутително, незаслужено
ordinariē - редовно, обикновено, обичайно

admonitū (+gen) - по съвет (на) (???)

grātuītō - гратис, даром, безплатно, безвъзмездно
tūtō - безопасно

rancide - отвратително, гадно
lēne - меко, леко, нежно

vehementer - изключително, жизнено, силно, знойно
obstinanter - инатливо, решено
libenter - с удоволствие, със щастие, охотно
lēniter - кротко, меко, мило, милостиво
hūmāniter - по човешки, хуманно, любезно
  perhūmāniter - вежливо, радушно, изключително любезно
cōnstanter - спокойно
tenāciter - настойчиво, непримиримо, непреклонно, непоколебимо
affābiliter - сговорливо, сговорчиво
continenter - въздържанo, непрекъснатo, непрестанно, поредно
misericorditer - състрадателно
immisericorditer - безчувствено, безмилостно, безпощадно
virīliter - мъжествено
essentiāliter - същностно, съществено
ōscitanter - изморено, сънливо, равнодушно
gnāviter/nāviter - усърдно, изрядно, напълно
furenter - яростно, ядливо, буйно, буйствено, бясно
concorditer - единодушно, мирно
discorditer - разногласно, размирно
commūniter - общо, обществено, заедно
longanimiter - търпеливо, с търпение, многострадално
aequāliter - равномерно, еднородно, равно, сходно
aequābiliter - равномерно, еднородно, равно, сходно
saeviter - свирепо, яростно, ядно
sēnsibiliter - доловимо, възприемливо
mātrōnāliter - като матрона, като госпожа, като омъжена жена
hospitāliter - гостоприемно
zēlanter - ревниво
participiāliter - (граматически) като причастие

facile/faciliter - лесно
difficile/difficiliter/difficulter - трудно
temere - непреценено, небрежно, наслуки, наслука, безцелно, безрасъдно, безразборно, лекомислено, сляпо, напразно, по случайност
maximē - много, особено, главно
minimē - хич, никак, ни най-малко


Graecē - на гръцки
Lаtīnē - на латински, на чист латински език (аналог на нашия израз)
Celticē - на келтски
Dānicē - на датски
