aliquantum - все няакакви, немалко, донякъде, някакъв брой, някакво количество
satis - достатъчно
nimis - прекалено, предостатъчно
nimium - предостатъчно, твърде много
vix - едвам
tantum - само
ferē - около, горе-долу, почти
circā - около, приблизително, относно
circiter - около, приблизително
dumtaxat - само, единствено, точно, тъкмо, тамън
funditus - напълно, изцяло, до дъно, коренно
adeō - дотолкова, точно
omnīnō - напълно, изцяло
sōlum - само, единствено
modo - само, едиствено
aliquot - няколко
nihil/nīl - никак

frūstrā - напразно, неуспешно
hīlum - нищожно, всуе, напразно, безсмислено, малоценно, хич (при негация)
porrō - насетне, нататък, още повече, отгоре, после, с препращане/пренасочване (???)
paene - почти, в близост
parum - твърде малко, недостатъчно
praecipuē - особено
praesertim - особено
plērumque - обикновено, по принцип, почти винаги

iūre - заслужено, наистина
meritō - заслужено
cōmiter - добронамерено, добродушно
clam - тайно, подмолно, скрито
incondonābile - непростимо
raptim - бързо, моментално, немедлено
ōcius - по-бързо, забързано
certātim - бойно
ultrō - доброволно, допълнително
dīvīnitus - божествено
