tantus - толкова голям
exiguus - малък, дребен
calidus - топъл
frīgidus - студен
dīmidius - намаляващ, смаляващ се
rēctus - верен, прав (в смисъл на истинен), прав (в смисъл на права линия)
prāvus - грешен
largus - щедър
paulum, minus, minimum - малко
cautus - предпазлив, внимателен, мнителен
audāx -ācis - смел, решителен
temerārius - дързък
caecus - сляп
surdus - глух
mūtus - ням
claudus - съкат
mortālis -is - смъртен
tūtus - безопасен, сигурен, предпазен, защитен, в безопасност
īnfēstus - опасен
attentus - внимателен, осторожен, внимаващ
vēlōx, -cis - бърз, пъргав
fēlīx, -cis - късметлив, успешен, благоприятен
īnīnfēlīx, -cis - карък
ignārus - неук
perītus - вещ
nōtus - знаен, известен
ignōtus - незнаен, неизвестен
nōbilis -is - известен, важен, аристократ
celsus - висок
fallāx -cis - лъжлив, мамещ, грешен
suāvis, -is - приятен, весел, сладък
iūcundus - приятен, задоволяващ
molestus - уморителен, неприятен, болезнен, отврятителен
īmus - долен
medius - среден
summus -горен
tardus - бавен, закъсняващ
sērus - закъснял, последен
acerbus - кисел
amārus - кисел
dulcis, -is - сладък
nimius - преголям, твърде голям
dēbilis -is - болен, слаб, кекав
ēbrius - пиян
avārus - алчен
fīdus - верен, доверен
fugitīvus - беглец
sapiēns -ntis - умен, мъдър, разумен
crūdēlis -is - жесток, див, освирепен
cārus - скъп (като цена), скъп (като близък човек)
vīlis -is - евтин, малоценен
idōneus - удобен, подходящ
posterus - следващ
dīrus - ужасен
incolumis - невредим, непокътнат
ācer ācris - деен, действен, деятелен, кисел (на вкус)
perpetuus - вечен
venustus - обичан, очарователен
passus - сушен
glaber - гладък
rigidus - здрав
lentus - бавен, мързелив
superbus - надменен, арогантен
dignus - достоен, заслужил
indignus - недостоен, нечестен
perītus - вещ, опитен
exercitātus - упражнен, подготвен, опитен
vīlis - пошъл
āmēns, āmentis - неразумен, откачен, изперкал. не с всичкия си
hirsūtos - космат, дебелокосмест, четинест
solitus - свикнал
capāx -cis - голям, обемист
ingēns -entis - огромен, неестествен
atrōx -cis - див, жесток, страшен, свиреп
pius - съвестен, праведен
impius - порочен, нечестив, безбожен, бедствен
mendāx -cis - лъжлив, фалшив
tepidus - хладък
tepidārius - хладъко воден
scaevus - ляв
supplex supplicis - молещ, коленичещ
vastus - обширен, огромен
alacer -cris - деятелен, щастлив, бърз, храбър
opulentus - богат
prīstinus - вехт
novissimus - последен
commodus - лесен
perennis -is - вечен
odōrātus - ухащ
ānxius - разтревожен
recēns -ntis - пресен, скорошен, нов, млад
continguus - слепен, съседен
pruīnosus - заскрежен, заледен
conterminus - съседен
gelidus - хладен, хладък
callidus - сръчен, хитър
sērious - късен, забавен
madidus - мокър
benignus - добронамерен
dōnātus - богат
pūtidus - развален
sollicitus - разтревожен
tortuōsus - трудно понятен
lepidus - чаровен, приятен
particeps, -ipis - участващ
macer - слаб, хилав, недохранен
assus - печен, жарен (?), грилован (?)
ineptus - глупав, недодялан
hebes hebetis - глупав
sēpār -is - отделен
piger - мързелив
industrius - работлив
miser - нещастен, болезнено влюбен
antīquus - античен, дрвен
novus - нов
cēterus - друг, останал
laetus - радостен
īrātus - бесен
probus - послушен
improbus - непослушен
vacuus - празен
pulcher, -rī - хубав, красив
foedus - грозен
amīcus - приятелски, полезен
inimīcus - враждебем, вреден
longus - дълъг
fessus - уморен, изморен
lassus - изморен, изтощен, отпаднал, изнурен
fōrmōsus - красив
plēnus (+gen) - пълен (с)
pecūniōsus - богат
gemmātus - украсен със скъпоценни камъни
nitidus - бестящ
vīvus - жив
mortuus - мъртъв
exanimis, -is - бездушен, мъртъв
crassus - дебел, широк
tenuis, -is - тънък
pullus - малък, млад
ferus - див, неопитомен
stultus - глупав
sānus - здрав, читав, психически добре
insānus - луд, откачен
aeger - болен, немощен
hūmānus - човешки
mōrigerus - покорен, послушен
tacitus - мълчалив
glaciālis, -is - леден, вледенен
trīstis, -is - тъжен, натъжен
armātus - въоръжен
brevis, -is - къс
gravis, -is - тежък
levis, -is - лек
barbarus - варварски, нецивилизован, див
altus - висок, дълбок
lātus - широк
fortis, -is - силен, могъщ, смел
dīmidius - половин
aequus - равен
clārus - ясен, светъл, отличим, отличен, знаменит, бележит
obscūrus - неясен, тъмен, потайнствен
indēclīnābĭlis - неизменен (граматически се позлва за съществителни, които имат единствена падежна форма)
indēclīnātus - непроменен
vernus - пролетен
aestĭfer, -is - зноен
sordidus - мръсен
pūrus - чист, изчистен, невинен, целомъдрен
nūdus - гол
togātus - облечен в тога, цивилен, римлянин
sinister - ляв
dexter - десен
sevērus - строг, суров, сериозен
vērus - истинен
falsus - грешен, лъжлив, объркан, неверен
candĭdātus - облечен в избелена тога
trux, trucis - див, свиреп
sēmis, -is - половин
frequēns, frequentis - чест, честосрещан
rārus - рядък, рядкосрещан
varius - различен
dīversus - разен, разнороден, разграничен
tālis, -is - такъв
turpis, -is - противен, безсрамен, отвратителен, грозен
mollis - мек, гъвкав, ковък
dūrus - твърд (и в преносен смисъл), здрав
bcātus - блажен, щастлив
necessārius - нужен, необходим
aliēnus - чужд
ūmidus - мокър, подгизнал
siccus - сух
mundus - изчистен
angustus - тесен
falsus - грешен, лъжлив
validus - здрав, силен
ferōx - див, свиреп
ferreus - железен
aureus - златен
aurātus - позлатен
ligneus - дървен
faber, fabrī - изкусен
integer, intergī - цял
plānus - ясен
dēbitus - дължим
amplus - голям, обемен
temperātus - подготвен, с мярка
aegrōtus - боледуващ
laevus - ляв
pār, paris - равен
subitus - внезапен, неочакван
cruentus - окървавен
sotdidus - мръсен, кален
timidus - страхлив
terribilis, -is - страховит
mīrābilis, -is - чуден
saevus - свиреп, яростен
cupidus - желаещ
arbitrātus - решен, преценен
gravidus - утежнен, подут
gravidа - бременна
mātūrus - зрял, съзрял
immātūrus/inmātūrus - незрял, недозрял, преждевременен
amoenus - великолепно, прекрасно, любителен
rūsticus - провинциален, селяндурски, пошъл
urbānus - градски, възпитан, с вкус
suburbānus - крайградски
rudis, -is - неук
patiēns, patientis - търпелив
impatiēns, impatientis - нетърпелив
neglegēns - небрежен
līber, līberī - свободен
studiōsus - любопитен, заинтересован, заинтригуван
propinquus - близък, близолежащ
longinquus - далечен
ūniversus - цял, пълнен
mor­tālis, -is - смъртен
immortālis, -is - безсмъртен
contrārius - насрещен, преден
secundus - попътен, заден
cōnstāns - спокоен
salvus - спасен
perīculōsus - опасен, бедствен
pretiōsus - скъп, скъпоценен
mīrus - чуден
maestus - тъжен, опечален
rapidus - бърз, пъргав, чевръст
inexspectātus - неочакван
dīligēns, dīligentis - усърден
argenteus - сребърен
glōriōsus - славен, преславен
acūtus - остър
absēns, absentis - отсъстващ, липсващ
praesēns, praesentis - присъстващ, наличен, текущ
asinīnus - магарешки
clēmēns, clēmentis - благ, щадящ, мек
iūstus - справедлив
iniūstus - несправедлив
scelestus - извратен, престъпен
crūdēlis, -is - жесток, безчовечен, брутален
christiānus - християнин
cūnctus - вси, всички, цял, всячески е, изцяло е
ēgregius - превъзходен, възхитителен, изключителен, извънреден, особен
commūnis, -is - споделен, всеобщ
grātus - приятен, благодарствен, благ
internus - вътрешен
nūbilus - облачен
adversus - насрещен
inermis - невъоръжен, обезоръжен
mūtuus - зает, взет назаем
mercātōrius - търговски
arduus - стръмен, труден
horrendus - страховит
ōtiōsus - почиващ, лежерен
prīvātus - частен
pūblicus - обществен
rīdiculus - смешен, смехотворен
mīlitāris - военен
circēnsis, -is - цирков
bellus - красив, хубав
dubius - съмнителен
geminus - близнашки
gladiātōrius - гладиаторски
iocōsus - забавен
mellītus - сладък
misellus - горък
poēticus - поетичен
scaenicus - театрален, сценичен
sērius - сериозен, строг
tenebricōsus - тъмен
turgidus/turgidulus - оточен, набъбнал
emāx - обичащ пазаруването
inconditus - груб, недодялан
grammaticus - граматически, граматик
vulnerātus - ранен
vīcīnus - близък, съседен
trigeminus - тризнак
lēgitimus - легитимен, законен, съществен
hostiīlis, -is - вражески
sepultus - погребан
īnsepultus - непогребан
intactus - недокоснат, невредим
invidiōsus - завистлив
luxuriōsus - луксозен, скъп, пищен, разточителен, разкошен
nātus - роден
nocturnus - нощен
opportūnus - сгоден, подходящ
ōrnātus - украсен, окичен
firmus - здрав, кален, издръжлив, убедителен
fūnestus - пропаднал, опасен, смъртоносен
futūrus - бъдещ
expedītus - подготвен, леко въоръжен, военизиран
extrēmus - краен
equestris - конен
religiōsus - религиозен
sacer, sacrī - свещен, сакрален
scelerātus - долен, престъпен
patricius - патрициански, благороден
plēbēius - плебейски, простолюден
prosperus - успял, успешен, късметлийски
prūdens, prūdentis - разумен, осъзнат
imprūdens, imprūdentis - неразумен
beātus - блажен, приятен
bellicōsus - войнствен
bellicus - военен
adversārius - противников
aeternus - вечен, за винаги
permanēns - постоянен
agrārius - аграрен, поземлен, земеделски
annuus - годишен, едногодишен
captīvus - уловен, заложнически
castus - целомъдрен
certus - сигурен
incertus - несигурен
clausus - затворен
patricius - патрициански
classicus - флотийски, патрициански
prōlētārius - пролетариански
ūnicus - един-единствен
peregrīnus - чужд, странен, чуждестранен
religiōsus - религиозен
illūstris, -is - светещ, блестящ, известен
hostīlis, -is - враж, противнически
dīversus - разнороден
strenuus - изтощителен, уморителен, храбър
occultus - скрит, таен
suprēmus - най-далечен
serēnus - чист, бистър, спокоен
cotīdiānus - всекидневен
immōtus - неподвижен
ūtilis, -is - потребно, полезно
praecipuus - особен
cōpiōsus - изобилен, плодороден
dēnsus - чест, гъст
dīvus - божествен
splendidus - бляскав
invidus - завистлив
violentus - буен
auricomus - блондин
occiduus - убийствен
coruscus - пробляскащ
imrnedicābilis, -e - неизлечим
rēgālis, -is - царствен
liquidus - течен
resupīnus - лежащ по гръб, облегнат назад
contentus - доволен, задоволен, удовлетворен
immītis, -is - див, жесток, свиреп, груб
libēns, libentis - желаещ, волеви, волен, весел, доволен
invītus - нежелаещ, неохотен, неволеви, неволен
anīlis, -is - бабешки
marīnus - морски
spīceus - житен, зърнен
puerīlis - момчешки, детински
patrius - татков
paternus - бащин
caelestis - небесен
iuvenālis - младежки
tener, -ī - мек, нежен, млад, слаб, женствен
silvester, -is - горски, див, необработен, неопитомен
publicus - обществен
prīvatus - частен, личен
mutuus - споделен, общ, взет назаем, зает
dēlicātus - деликатен, разкошен, разглезен, женствен
cotīdiānus - всекидневен
hodiernus - днешен
calceātus - обут
dormītōrius - спален
pusillus - дребен
prānsus - нахранен, приключил обяда си
amantissimus - най-благ
cārissimus - най-скъп
frūgālis, -is - семпъл, пестелив, скромен
domesticus - домашен
holerārius - зеленчуков
subdīvālis, -is - открит, без покрив
fervēns, -entis - кипящ, пламенен, жарък, въодушевен
ēscārius - годен за ядене
ingenuus - роден от свободни родители, естествен, щедър
opportūnus - удобен, пригоден, подходящ
modicus - умерен
sēcūrus - безгрижен, предпазен
causidicus -

amāns, amantis - любящ
perturbātus - шашардисан
perversus - извратен, зъл
ustus - горян
vehemēns, -entis - насилващ, буен
haustus - точен, източен, излят
cultus - поддържан, обработен
vulgāris, -is - народен, общ, обществен
agēns - действащ

superior, summus - по-горен, по-висок, пръв
īnferior, īnfimus - по-долен, по-нисък, последен
interior, intimus - по-вътрешен
exterior, extrēmus - по-външен, по-краен
ulterior/ulterius, ultimus - по-далечен
citerior/citerius, citimus - по-близък
propior, proximus - по-близък

niveus - снежно бял
eburneus - бял като слонова кост
cānus - бял
candidus - бляскаво бял
albus - матово бял
niger - бляскаво черен
āter - матово черен
pulus - тъмноцветен, черен
prasinus - светло зелен
viridis -is - зелен
purpureus - пурпурен
ruber, rubrī - червен
caerŭleus - светло син
rutilus - оранжев
croceus - златно жълт
crocinus - шафранено жълт
superus - горен
īnferus - долен
maritimus - морски
tranquillus - спокоен
turbidus - бурен, бушуващ
contrārius - противостоящ
pallidus - блед, жълтеникав

proprius - конкретен, собствено (съществително)
appellātīvus - нарицателен, нарицателно (съществително)
actīvus - в деятелен залог
passīvus - в страдателен залог
cōpulātīvus - съединителен
disiūnctīvus - разделителен
explētīvus - допълващ, запълващ
causālis - причинен
ratiōnālis - разумен


tōtus, -īus - цял, пълен, целокупен
sōlus,-īus - сам, единствен
ūllus,-īus - някой, но винаги се използва с отрицание за получаване на никой/нито един
nūllus,-īus - нула, без
ūnus, -īus, m - един
ūna, -īus, f - една
ūnum, -īus, n - едно
duo, -ōrum, m/n pl - два
duae, -ārum, f pl - две
dua, -ōrum, n pl - две
ambō, ambōrum, m pl - и двата
ambae, ambārum, f pl - и двете
ambō, ambōrum, n pl - и двете
trēs, trium, m/f pl - три
tria, trium, n pl - три
quattuor, indecl - четири
quīnque, indecl - пет
sex, indecl - шест
septem, indecl - седем
octō, indecl - осем
novem, indecl - девет
decem, indecl - десет
ūndecim, indecl - единайсет
duodecim, indecl - дванайсет
trēdecim, indecl - тринайсет
quattuordecim, indecl - четиринайсет
quīndecim, indecl - петнайсет
sēdecim, indecl - шеснайсет
sepemdecim, indecl - седемнайсет
duodēvīgintī, indecl - осемнайсет
ūndēvīgintī, indecl - деветнайсет
vīgintī, indecl - двайсет
trīginta, indecl - трийсет
quadrāginta, indecl - четирисет
quīnquāginta, indecl - петдесет
sexāginta, indecl - шейсет
septuāginta, indecl - седемдесет
octōginta, indecl - осемдесет
nōnāginta, indecl - деветдесет
centum, indecl - сто
ducentī - двеста
trecentī - триста
quadringentī - четиристотин
quīngentī - петстотин
sescentī - шестотин
septingentī - седемстотин
octingentī - осемстотин
nōngentī - деветстотин
mīlle, indecl - хиляда
mīllia, indecl - хиляди
omnis, -is - всички, цял

prīmus - първи
secundus - втори
tertius - трети
quārtus - четвърти
quīntus - пети
sextus - шести
septimus - седми
octāvus - осми
nōnus - девети
decimus - десети
ūndecimus - единайсти
duodecimus - дванайсти
duodēvīcēsimus - осемнайсти
ūndēvīcēsimus - деветнайсти
vīcēsimus - двайсти
trīcēsimus - трийсти
quadrāgēsimus - четирийсти
quīnquāgēsimus - петдесети
sexāgēsimus - шейсети
septuāgēsimus - седемдесети
octōgēsimus - осемдесети
nōnāgēsimis - деветдесети
centēsimus - стотни
duocentēsimus - двустотни
trecentēsimus - тристотни
quadringentēsimus - четиристотни
quīngentēsimus - петстотни
sescentēsimus - шестстотни
septingentēsimus - седемстотни
octingentēsimus - осемстотни
nōngentēsimus - деветстотни
mīllēsimus - хилядни
postrēmus - последен

singulī - един по един, по едно, по единици
ūnī - един по един, по едно, по единици (използва се за чисто множествени съществителни)
bīnī - два по два, по две, по двойки
ternī - три по три, по три, по тройки
trīnī - три по три, по три, по тройки (използва се за чисто множествени съществителни)
quaternī - чретири по четири, по четири, по четворки
quīnī - пет по пет, по пет, по петици
sēnī - шест по шест, по шест, по шестици
dēnī - десет по десет, по десет, по десетки

Graecus - гръцки
Rōmānus - римски
Latīnus - латински

necesse, indecl - необходимо, задължително


meus - мой
tuus - твой
suus - свой
noster - наш
vester - ваш

prior, -is - преден, предишен
posterior, -is - заден, по-заден, следващ
īnferior, -is - долен, по-долен, по-млад, по-дребен


facilis, -is - лесен
difficilis, -is - труден
gracilis, -is - грациозен, слаб, изпит
humilis, -is - нисък, низък, неизвестен
similis, -is - подобен, сходен
dissimilis, -is - различен, инакъв


bonus, melior, optimus - добър
malus, pēior, pessinus - лош
magnus, māior, māximus - голям
parvus, minor, minimus - малък
multī, plūrēs, plūrimī pl - многобройни
complūrēs, -ēs - изобилни, несчетни
multum, plūs plūris, plūrimum - много
nēquam (indecl),nēquior, nēquissimus - подъл, отвратителен, низък, безполезен

celer, celeris, celere - бърз

vetus, veteris - вехт, стар, древен
dīves, dīvitis, dīvitior, dīvitissimus - богат
pauper, -is - беден


Aegyptius - египетски
Ãfricānus - африкански
Albānus - албански (в смисъл свързан с древния град Алба Лонга или Албанските планини в Италия)
Asiānus - азиатски
Britannus - британски
Cannēnsis - кански
Carthāginiēnsis - картагенски
Delphicus - делфийски
Eurōpaeus - европейски
Etrūscus - етруски/етрускски (!!!)
Gabīnus - габийски
Gallus- галски
Germānus - германски
Graecus - гръцки
Hispānus - испански
Italicus - италийски, апенински
Italus - италиански
Lūsītānus - лузитански, т.е. португалски
Thraex - тракийски
Tūsculānus - тускулански
Rōmānus - римски
Sabīnus - сабински
Pūnicus - пунически, картагенски
