paulus - малък
paullulus - малкичък
pauxillus - малък, дребен
pauxillulus - възмалък, въздребен, миниатюрен
exiguus - нищожен, оскъден, малък, дребен, точен, премерен
calidus - топъл
frīgidus - студен
dīmidius - половин
prōrsus - прав, пряк, непосредствен, прозаичен
prāvus - грешен
largus - щедър
temerārius - дързък
caecus - сляп
surdus - глух, тих, неотчетлив
absurdus - глупав, безсмислен, несвързан, (преносно) разхвърлян, абсурден
mūtus - ням
claudus - съкат
īnfēstus - опасен, вражески, в бойна готовност
ignārus - неук
perītus (+gen) - вещ, опитен
imperītus - неук, неопитен
molestus - уморителен, неприятен, болезнен, отврятителен
acerbus - кисел, горчив
amārus - горчив
valētūdinārius - кекав, хипохондрик
ēbrius - пиян
avārus - алчен
fīdus - верен, доверен
  perfīdus - лъжлив, лукав, коварен, измамен, предателски
aptus - подходящ, достоен, готов
ineptus - глупав, недодялан
dīrus - ужасен
perpetuus - вечен
  imperpetuus - преходен, мимолетен
aeternus - вечен, за винаги
sempiternus - всевечен, вековечен
perennis - вечен, траен
venustus - обичан, очарователен, обаятелен
passus - сушен
rigidus - здрав
fīrmus - устойчив, здрав, як, крепък, твърд, кален, издръжлив, убедителен
īnfīrmus - болен, кекав, крехък, болен, неуверен, немощен, безсилен, трошлив
superbus - надменен, арогантен, високомерен, високопарен, горделив, горд
dignus - достоен, заслужил
indignus - недостоен, нечестен, възмутителен
hirsūtus - космат, дебелокосмест, четинест
vāstus - огромен, обширен, празен, опустошен, безлюден
pius - съвестен, праведен
impius - порочен, нечестив, безбожен, бедствен
tepidus - хладък
tepidārius - хладъко воден
scaevus - ляв
opulentus - богат
prīstinus - вехт
novissimus - последен
commodus - удобен, подходящ, учтив, лесен
incommodus - неприятен
ānxius - разтревожен, развълнуван, обезпокоен
sollicitus - разтревожен, тревожен, развълуван, безпокоен, загрижен, възбуден
continguus - слепен, съседен
pruīnosus - заскрежен, заледен
conterminus - съседен
gelidus - хладен, хладък
callidus - сръчен, хитър
astūtus - сръчен, хитър, изкусен, обигран
catus - ловък, хитър, схватлив, умен
sērious - късен, забавен
madidus - мокър, сочен, пропит, напит, подгизнал, накиснат, пиян, пийнал, попийнал
ūmidus - мокър, подгизнал
ūvidus - мокър, пропит, пиян, блудкав
ūdus - мокър, влажен. подгизнал
benignus - благосклонен, добронамерен, доброжелателен
pūtidus - развален
lepidus - чаровен, приятен
assus - печен, жарен (?), грилован (?)
industrius - работлив, усърден, старателен, деятелен
antīquus - античен, дървен
novus - нов
cēterus - друг, останал
laetus - радостен
probus - послушен
improbus - непослушен, лош, зъл, порочен, нагъл, неприличен
vacuus/vacīvus - празен
foedus - грозен
amīcus - приятелски, полезен
inimīcus - враждебем, вреден
longus - дълъг
longulus - дълъг
longiusculus - по-дългичък, дългичък
fessus - уморен, изморен
lassus - изморен, изтощен, отпаднал, изнурен
fōrmōsus - красив, добре оформен
īnformis - грозен, неугледен, безформен
plēnus (+gen) - пълен (с)
pecūniōsus - богат
gemmeus - със скъпоценни камъни
nitidus - бестящ
vīvus - жив
sēmivīvus - полужив, полумъртъв
mortuus - мъртъв
ferus - див, неопитомен
stultus - глупав
stupidus - глуповат, глупав, тъп
sānus - здрав, читав, психически добре
īnsānus - луд, откачен
hūmānus - човешки
mōrigerus - покорен, послушен
lātus - широк, просторен
aequus - равен, честен, справедлив
inīquus - неравен, нечестен, несправедлив, враждебен
lūculentus - сияещ, очароващ, значителен
lūcidus - ярък, ясен
dīlūcidus - ярък, ясен, различим
clārus - бистър, ясен, светъл, отличим, отличен, знаменит, бележит
  praeclārus - пресветъл, пребистър, прояснен, прегледен, прочут, изтъкнат
obscūrus - неясен, тъмен, потайнствен
  perobscūrus - смътен, мъгляв, потаен
vērnus -  пролетен
aestīvus - летен
auctumnus - есенен
hībernus - зимен, зазимен
pūrus - чист, изчистен, невинен, целомъдрен
nūdus - гол
togātus - облечен в тога, цивилен, римлянин
praetextātus - млад, юноша
laevus - ляв, тромав
sevērus - строг, суров, сериозен
vērus - верен, истинен
falsus - грешен, лъжлив, объркан, неверен
candidātus - облечен в избелена тога, облечен в бяло
rārus - рядък, рядкосрещан
varius - различен
dīversus - разен, разнороден, разграничен
dūrus - твърд (и в преносен смисъл), здрав
necessārius - нужен, необходим
aliēnus - чужд
siccus - сух
mundus - изчистен
immundus - омърсен, замърсен, изцапан, кирлив
angustus - тесен, свит, сбит, кратък
artus - тесен, строг, оскъден, кратък
validus - здрав, крепък, силен
plānus - ясен
manifēstus - очевиден, ясен, несъмнен, хванат по време на извършване на престъпление
amplus - голям, обемен
aegrōtus - боледуващ
subitus - внезапен, неочакван, ненадеен
repentīnus - внезапен, неочакван, ненадеен
cruentus - окървавен
sotdidus - мръсен, кален
timidus - страхлив
pavidus - изплашен
pavibundus - изплашен, страхлив, разтревожен
cupidus - желаещ
gravidus - утежнен, подут
gravidа - бременна
amoenus - великолепно, прекрасно, любителен
rūsticus - провинциален, селски, прост, груб, пошъл
rustĭcānus - селяшки, селяндурски, торлашки
pāgānus - селски, езически, цивилен
urbānus - градски, възпитан, с вкус
inurbānus - безвкусен, просташки
suburbānus - крайградски
studiōsus - любопитен, заинтересован, заинтригуван
longinquus - далечен
ūniversus - цял, пълнен
secundus - попътен, заден
salvus - спасен
perīculōsus - опасен, бедствен
pretiōsus - скъп, скъпоценен
mīrus - чуден, чудесен, чудноват
rapidus - бърз, пъргав, чевръст
tardus - бавен, тромав, закъсняващ
lentus - ленив, бавен, муден, тромав, мързелив
sērus - закъснял, последен
glōriōsus - славен, преславен
asinīnus - магарешки
iūstus - справедлив
iniūstus - несправедлив
scelestus - извратен, престъпен
cūnctus - вси, всички, цял, всячески е, изцяло е
ēgregius - превъзходен, възхитителен, изключителен, извънреден, особен
internus - вътрешен
externus - външен
nūbilus - облачен
adversus - насрещен
mercātōrius - търговски
arduus - стръмен, труден
horrendus - страховит
formīdolōsus/formīdulōsus - страховит, страшен, ужасяващ, изплашен, ужасен
ōtiōsus - почиващ, лежерен
pūblicus - обществен
rīdiculus - смешен, смехотворен
dubius - съмнителен
geminus - близнашки
gemellus - близнашки
gladiātōrius - гладиаторски
iocōsus - забавен
salsus - подсолен, солен, остроумен, забавен (от посолен/обсипан с шега)
mellītus - меден, покрит/подсладен с мед, сладък
misellus - горкичък
poēticus - поетичен
scaenicus - театрален, сценичен
sērius - сериозен, строг
tenebricōsus - тъмен
turgidus/turgidulus - надут (буквално), надут (преносно), оточен, набъбнал
tumidus - надут (буквално), надут (преносно), оточен, набъбнал, бурен
turbidus - бурен, бушуващ
turbulentus - бурен, бушуващ
vīcīnus - близък, съседен
trigeminus - тризнашки
lēgitimus - легитимен, законен, законов, съществен
invidiōsus - завистлив
luxuriōsus - луксозен, скъп, пищен, разточителен, разкошен
nocturnus - нощен
opportūnus - сгоден, удобен, пригоден, подходящ
fūnestus - пропаднал, опасен, смъртоносен
perniciōsus - унищожителен, разрушителен, смъртоносен, болестотворен
futūrus - бъдещ
extrēmus - краен
religiōsus - религиозен
patricius - патрициански, благороден
plēbēius - плебейски, простолюден
prosperus - успял, успешен, късметлийски
bellicōsus - войнствен
bellicus - военен
adversārius - противников
agrārius - аграрен, поземлен, земеделски
annuus - годишен, едногодишен
captīvus - пленeн, хванат, уловен, спипан
castus - целомъдрен (непорочен), целомъдрен (девствен)
pudīcus - срамежлив, непорочен, благороден
certus - сигурен
incertus - несигурен
clausus - затворен
classicus - флотийски, патрициански
prōlētārius - пролетарски
ūnicus - един-единствен
peregrīnus - чужд, странен, чуждестранен
serēnus - чист, бистър, спокоен
cotīdiānus/cottīdiānus/quotīdiānus - всекидневен
hodiernus - днешен
dormītōrius - спален
praecipuus - особен
cōpiōsus - изобилен, плодороден, гъст
dēnsus - чест, гъст
spissus - чест, гъст, претъпкан, закъснял
dīvus - божествен
dīvīnus - божествен, свещен
splendidus - бляскав
invidus - завистлив
violentus - буен, насилствен
auricomus - блондин
occiduus - убийствен
coruscus - пробляскващ
supīnus - лежащ по гръб, движещ се назад, ретрограден, безразсъден, ленив
resupīnus - лежащ по гръб, облегнат назад
invītus - нежелаещ, неохотен, неволеви, неволен
patrius - татков
paternus - бащин
mūtuus - зает, взет назаем, споделен, общ
dēlicātus - деликатен, разкошен, разглезен, женствен
pusillus - дребен
perpusillus - въздребен
prānsus - нахранен, приключил обяда си
amantissimus - най-благ
cārissimus - най-скъп
holerārius - зеленчуков
ēscārius - годен за ядене
ingenuus - роден от свободни родители, естествен, щедър
modicus - умерен
  immodicus - краен, прекомерен, прекален
surreptīcius - краден, откраднат
sēdulus - усърден, настойчив, упорит
pluvius - дъждовен
tranquillus - спокоен
contrārius - насрещен, противостоящ, преден
avidus - алчен
tragicus - трагичен
tragoedus - трагичен
cōmicus - комичен
cōmoedus - комичен
rāmōsus - клонест, клонат
oblīquus - наклонен, кос, полегат
līmus - кос, полегат, накривен, наклонен
līmulus - кос, полегат, накривен, наклонен
horridus - страшен
terrificus - плашещ, страшен
torvus - страшен, плашещ, див, безмилостен, угнетителен
trepidus - треперещ от страх, нервен, разтревожен
  intrepidus - безстрашен, неустрашим, безтревожен
cūriōsus - внимателен, грижовен, любознателен, любопитен
incūriōsus (+gen/abl) - невнимателен, безгрижен, безразличен, невнимателно изработен
obvius - насрещен, често срещан, очевиден
rōbustus - дъбов, корав, здрав, силен, възмъжал, мощен, устойчив
fēstivus - празничен, забавен, весел
tortuōsus - лакатушещ, заплетен, забъркан, сложен за разбиране, трудно понятен
philosophicus - философски
rhētoricus - реторичен
ōrātōrius - ораторски
canīnus - кучешки
garrulus - празнодумен, бъбрив
īrācundus - раздразнителен, сприхав
aquilīnus - орлов
liquidus - течен
marīnus - морски
maritimus - морски
strēnuus - изтощителен, уморителен, работлив. пъргав, трескав, натоварен, деен, храбър
minitābundus - заплашителен
avītus - старчески, старешки дядовски, древен, родословен
vespertīnus - вечерен
domesticus - домашен
grātus - приятен, посрещнат, желан, скъп, благ, благодарствен
bellus - красив, хубав
hosticus - противников, вражески
sēcūrus - безгрижен, предпазен
disertus - изразителен, сладкодумен, имащ дар слово
indisertus - пелтечещ, смотолевящ, с беден език, лишен от дар слово
dēlīrius - откачен, луд, шантав
curtus - осакатен, счупен, обрязан, кастриран, съкратен
saevus - свиреп, яростен
concinnus - спретнат, прибран, изящен, красив, угледен, приличен, елегантен, подреден
concinnāticius - изящен, изискан
inconcinnus - немарлив, неловък, стеснителен, разхвърлян, калпав, непохватен, несръчен
christiānus - християнин
sordidus - мръсен (буквално), мръсен (преносно)
spurcus - мръсен (буквално), мръсен (преносно)
squālus - мръсен, неподдържан
squālidus - грубоват на допир, мръсен, неподдържан, изоставен
pullus - малък, млад
barbarus - варварски, нецивилизован, див
crassus - дебел, широк
tūtus - безопасен, сигурен, предпазен, защитен, в безопасност
iūcundus - сладостен, удовлетворителен, приятен, задоволяващ
celsus - висок
excelsus - възвисок, издигнат
nimius - преголям, твърде голям
īnfīnītus - безкраен
fugitīvus - беглец
kārus/cārus - скъп (като цена), скъп (като близък човек)
odiōsus - омразен, ненавиждан, ненавистен
prōmiscuus, -ī - смесен, общ, споделен
sānctus - свещен
numerōsus - многоброен
eximius - подбран, избран, изключителен
prīmōgenitus - първороден
pilōsus - космат
placidus - нежен, спокоен, мек
faustus - благоприятен, щастлив, късметлив
opīmus - дебел, пълен, богат, плодороден
mēnsōrius - мерителен
credulus - доверчив, наивен, лековерен
dīvīnius - божествен
macilentus - хърбав
prōnus - легнал по корем, легнал с лицето надолу, наклонен напред, наведен
orbus - лишен от деца, сирак, вдовец
propitius - благосклонен, милостив
parvulus - мъничък
gnāvus - деятелен, зает
ignāvus - безделен, мързелив, ленив, непродуктивен, безплоден, страхлив
rēgius - царствен, царски, кралски
stupendus - изумителен, шеметен
proximus - ближен
frētus (+abl) - уверен (в), доверяващ се (на)
scius - вещ, мъдър, сведущ, запознат, осведомен
  īnscius - некадърен, неспособен
  cōnscius - съзнателен, съзнаващ, знаещ, посветен, осведомен
  nescius - невеж, неграмотен
fēstus - тържествен, празничен, весел
proprius - собствен, личен, свойствен, присъщ
  proprius (+gen) - удачен (за)
aulicus - придворен, царедворски
benevolus - доброжелателен, добронамерен
malevolus - зложелателен, злонамерен
cavus - кух, шуплест
cassus - кух, празен, безплоден, безсмислен
cavernōsus - надупчен, шуплест, порест
sincērus - искрен, честен, естествен, чист, невредим
iēiūnus - гладен, постещ, постен, оскъден
maledicus - злословен
egēnus - сиромашки
beneficus - добротворен
maleficus - злосторен
hērēditārius - наследствен, наследен
diūturnus - дълготраен
generōsus - благороден, от потекло, щедър, добросърдечен
profānus - скверен, профанен
grātiōsus - мил, приятен, грациозен
stipendiārius - данъкоплатец
innumerus - безброен, безчетен
truncus - сакат, ампутиран, отрязан, непълен
frāternus - братски
adulēscentulus - младичък, много млад
nefārius - подъл, извратен, покварен, скверен
aemulus - сходен, завистлив, ревнив, съпернически
profundus - дълбок
prōlixus - разперен, обширен, протяжен, проточен, щедър
cōnsternātus - смутен, объркан, разтревожен
quadrātus - квадратен
rotundus - объл, кръгъл
augustus - свещен, почитан, достопочтен, тачен
subterrāneus - подземен
domesticus - домашен
boārius - говедарски
anniversārius - годишен
profugus - бежански
saucius - ранен
curvus - огънат
īnfandus - неописуем, неизразим, чудовищен
nefandus - неописуем, неизразим, чудовищен
dĕcōrus - декориран, украсен, красив, гиздав, подходящ, подобаващ
fortūnātus - късметлив, щастлив, богат
lūxus - разместен
ālātus - крилат
uxōrius - под чехъл, принадлежащ на съпруга
fidus - надежден, верен, сигурен, несъмнен, обещаващ
perfidus - ненадежден, неверен, несигурен, коварен, вероломен
moribundus - умиращ
sanguineus - кръвен, кръвожаден
virātus - мъжествен
fēminātus - женствен
finitimus - граничен
vetustus - вехт, стар, древен
longaeus - престар, вехт
lacrimōsus - насълзен, сълзлив
opācus - сенчест, засенчен, сумрачен, затъмнен, помрачен, непрозрачен, непрогледен
fētus - бременна, плодороден, изобилен
vānus - празен, напразен, безцелен, безсмислен, лъжлив
blandus - любезен, приятен, примамлив, съблазнителен, ласкателен, похвален, хвалебствен
fāstus - разрешен, който е спрямо божествените закони, богоугоден
nefāstus - забранен, който е против божествените закони, скверен
fortuītus - случаен
aduncus - с извит/огънат край, с кука
amātōrius - любовен
assiduus - постоянен, непрестанен, непрекъснат, вечно наличен
novellus - младичък, мъничък (на възраст)
tessellātus - мозаичен
opiparus - нагизден, богат, гиздав, великолепен, барнат
carnōsus - месест
denticulātus - назъбен
guttātus - петнист (букв. с капчици)
hortulānus - градински
postīcus - заден
veterāmentārius - вехтошарски
cōnspicuus - видим, забележителен, бележит, поразителен, изтъкнат
anhēlus - запъхтян, задъхан, задъхващ, тревожен, мимолетен
iūrgiōsus - свадлив
rixōsus - свадлив, борбен
importūnus - неподходящ, калпазански, свадлив, груб, жесток, див, безчовечен
pustulātus - крастав, с циреи
dēfīnītuus - определителен, определящ
linteātus - облечен с ленени дрехи
tabulātus - подов, със под
beātificus - облагородяващ
culpātus - порицаем, укорен, осъдителен
semitārius - улучен
plāgātus - белязан с цепнатина, процеп, аралък
plātōsus - пребит, тежко ранен
plānātus - приземен
dēvius - който е/отива извън/далеч от пътя, отдалечен, уединен, разпътен, непоследователен
hesternus - вчерашен
crāstinus - утрешен
perendinus - другиденшен
dēterrimus - най-лош, най-беден, най-подъл
facētus - изискан, изтънчен, вежлив, учтив, разсъдлив, остроумен
sandaliārius - сандалов
scrūpōsus - който има остри/нащърбени камъни
scrūpulōsus - скрупулен
populābundus - опустошителен, разрушителен, унищожителен
ridibundus - засмян, смеещ се
crispus - къдрав, накъдрен
coculeātus - спирален, спираловиден
faenerātōrius - лихварски
obscēnus - мерзък, отвратителен, отблъскващ, гаден, гнусен, вещаещ зло
vīllāticus/vīllātus - фермен
chlamydātus - облечен във военен плащ
catholicus - католически
trifurcus - с три зъба
pygmaeus - възкъс, джуджов/джуджейски???
pūmilus - дребен
cubiculārius - спален (в смисъл на свързан със спалня)
cellārius - складов
carbōnārius - въглищен
venēnātus - отровен
hāmātus - крив, закривен, с форма на кука
triangulus - триъгълен
rabidus - бесен
furibundus - вбеснен, побеснял, яростен, неистов, вдъхновен
mōrātus - с определени нрави/маниери, маниерен, културен
honestus - честен (обвързан с чест), честен (казващ истината), почтен, достоен, красив
sanctus - свят, свещен
imbēcillus - кекав, слаб, глупав
imbēcillōsus - кекав, слабоват, глуповат
irritus - незначителен, нищожен, безполезен, празен, безсмислен, безсъдържателен
subtēgulāneus - подпокривен
sūmptuōsus - скъп, разхитителен, разточителен, редкопръст
coquīnus - готварски
mūrīnus - миши/плъши, миша/плъша, мише/мишо/плъше
concomitātus - придружен
oriundus - произхождащ, роден
verēcundus - срамежлив, засрамен, почитаем
  inverēcundus - срамен, безсрамен
exsultābundus - скачащ от радост
plusculus - повечко (ако имаше съответстващо прилагателно име)
amnicus - речен
rīvālicius - от човек, споделящ същата река/бързей
rhīnocerōticus - носорогов, присмиващ се
brochus/broccus/broccus/broncus - със стърчащи зъби
pavīmentātus - павиран, с под
historicus - исторически, историчен
sapidus - вкусен, апетитен, мъдър
rancidus - гнил, развален, гранив, гранясал, смрадлив, вмирисан, зловонен, гаден, отвратителен
rancidulus - гниличък, смрадливичък, гадничък
mōnstruōsus - чудовищен, странен
gallīnārius - кокоши, пилешки
bardus - глупав, тъп, слабоумен, малоумен
officiōsus - услужлив, отзивчив
fānāticus - храмов, вдъхновен божествено, буйствен, луд, фанатичен
ānulārius - пръстен-печатен
ānulātus - с пръстен, окован
hērōicus - героичен, епичен
hērōus - героичен, епичен
pathēticus - патетичен, трогателен, прочувствен, драг
squāmōsus - люспест
squāmātus - люспест
fragōsus - чуплив, трошлив, груб, начупен, неравен, неравномерен
dominicus - господствен
supervacāneus - ненужно голям, излишен
nātīvus - вроден, естествен, природен, първичен, роден, създаден
fascinōsus - с голям пенис
vātī̆cānus - ватикански
veterānus - стар, ветеран
corallinus - коралов
sopōrus - приспиващ, сънлив
pervius - проходим, прекосим, проницаем
  impervius - непроходим, непрекосим, непроницаем
perspicuus - прозирен, проницаем, прозрачен, ясен
  imperspicuus - непроницаем, непрозрачен, неясен, смътен
crūdus - суров (недопечен и т.н.), суров (неузрял), суров (за характер), зелен (за плод)
  sēmicrūdus - полусуров, с неслегнала храна
mīrandus - чуден, чудесен, изумителен
mīrificus - чудотворен, чуден
mīrāculus - причудлив, уродлив, недъгав
manifestus - спипан по време на извършване на престъпление, очевиден, безпогрешен, несъмнен
flaccidus - отпуснат, увиснал, вял, немощен
virōsus - мъжкарка (аналог на женкар)
ambitiōsus - амбициозен, славолюбив, който е перко, наперен, показен, усукан, навит, ласкателен
algificus - изстудяващ
algidus - студен, вледенен
aprīcus - слънчев (огрян от слънцето), радостен, щастлив
sacrilegus - богохулен; крадящ сетини
dēlīrus - щур, пѐрнат, луд, смахнат
flāminius - свещелнически
ferōculus - дивичък, свирепичък
pulchellus - красивичък, хубавичък
tenellus - нежничък, мекичък
suāsōrius - убедителен
suādus - убедителен
adhaesivus - лепкав, прилепчив
mētropolītānus - метрополски
sedentārius - уседнал
sēdātīvus - успокояващ, със свойства на седатив
statuārius - статуен
ōscitābundus - прозяващ се
parcus - щадящ, пестелив, спестовен, икономичен

tantus - толкова голям
tantulus - толкова малък
tantillus - толкова малкичък
quantus - колкото голям, дотолкова голям
quantulus - колкото малък
quantillus - колкото малкичък

bīmus - двегодишен, двугодишен (букв. дву-зимен)
biduus - двудневен

duplus - двоен

ferreus - железен
aureus - златен
ligneus - дървен
argenteus - сребърен
spīceus - житен, зърнен
igneus - огнен
lapideus - каменен
marmoreus - мраморен
latericius - тухлен
aereus - меден, бронзов
aēneus - меден, бронзов, месингов
ēscārius - хранителен (отнасящ се за храна)
strāmineus - сламен
līneus - ленен
lolleāceus - от райграс
pelliceus - кожен
faeneus - сламен
strāmineus - сламен
vitreus - стъклен, прозрачен
metallicus - метален
cinereus - пепеляв
vīteus - лозов

idōneus, magis idōneus, maximē idōneus - удобен, подходящ

Scyllaeus - Сцилов
Cyclōpius - Циклопов
Sāturnius - Сатурнов
Tiberīnus - Тибъров
Sophoclēus - Софоклев
