ad - към (приближаване)
prope - близо
apud - заедно с
ob - вместо, заради
iūxtā - до, близо, с
propter - близко до, в близост на
ante - пред
adversam - срещу, към
cis - оттук, близо, от тази страна
citrā - отсам
ultrā - отвъд
trāns - през, оттам
per - чрез, през
circā - около, близо до, приблизително (за време)
circum - около
contrā - срещу
ergā - към
extrā - отвън, извън
inter - среден
intrā - в, вътре в
īnfrā - под, надолу от
subter - под, долу, отдолу на
praeter - освен
propter - заради, поради
post - след, зад
secundum - по, след, зад, до, по дължината на
secus - редом с, успоредно на, до, по дължината на, покрай
ultrā - извън
suprā - над, нагоре от
adversus - срещу, към, в посока на
